datestr,A_plus,A_minus,B_plus,B_minus,AB_plus,AB_minus,O_plus,O_minus,total
20070101,0,0,0,0,0,0,0,0,0
20070102,70,5,40,3,10,1,115,14,258
20070103,81,12,24,4,4,1,117,16,259
20070104,82,10,40,8,8,1,150,15,314
20070105,109,14,37,6,11,1,157,26,361
20070106,104,11,25,6,9,3,123,7,288
20070107,28,5,12,1,1,1,35,3,86
20070108,105,19,45,2,8,0,166,20,365
20070109,122,17,52,4,20,1,163,21,400
20070110,103,9,31,5,7,1,137,12,305
20070111,79,16,25,4,7,0,131,19,281
20070112,96,7,39,1,8,2,124,8,285
20070113,48,9,21,4,13,1,81,14,191
20070114,22,5,10,1,4,0,43,2,87
20070115,95,10,48,2,14,0,102,12,283
20070116,73,12,20,2,12,0,116,16,251
20070117,99,8,31,5,9,0,113,10,275
20070118,84,11,28,4,8,0,111,12,258
20070119,86,6,32,4,7,3,114,13,265
20070120,45,6,14,2,3,0,51,9,130
20070121,25,1,5,3,1,1,33,1,70
20070122,70,13,41,2,8,0,130,10,274
20070123,76,7,35,7,6,2,114,9,256
20070124,78,13,33,1,9,1,131,12,278
20070125,69,8,35,1,8,1,100,15,237
20070126,85,6,31,4,7,1,110,15,259
20070127,57,7,33,3,8,0,102,13,223
20070128,18,0,4,0,1,0,28,6,57
20070129,87,10,34,3,7,0,124,17,282
20070130,91,14,28,4,5,0,117,14,273
20070131,109,14,45,7,14,0,134,28,351
20070201,99,14,37,0,13,0,120,21,304
20070202,110,12,42,4,11,1,161,18,359
20070203,60,6,23,4,5,1,95,17,211
20070204,9,0,6,0,2,1,22,1,41
20070205,91,14,30,4,10,2,127,20,298
20070206,122,11,27,6,9,1,151,17,344
20070207,106,15,40,7,8,1,174,20,371
20070208,123,13,40,1,13,2,184,24,400
20070209,107,11,41,4,14,2,137,19,335
20070210,72,10,19,1,10,1,83,5,201
20070211,16,0,7,1,2,0,25,1,52
20070212,113,10,30,3,13,0,149,10,328
20070213,112,9,36,3,8,2,143,25,338
20070214,99,19,45,8,13,2,162,14,362
20070215,149,22,44,3,11,2,181,24,436
20070216,123,11,47,2,16,1,189,30,419
20070217,39,6,19,1,4,0,46,12,127
20070218,10,4,3,0,3,0,21,1,42
20070219,24,4,8,0,2,0,41,12,91
20070220,18,2,6,0,1,1,25,3,56
20070221,38,5,13,2,5,2,45,4,114
20070222,53,2,17,2,5,2,88,12,181
20070223,76,9,23,1,5,1,87,15,217
20070224,38,3,16,2,6,0,53,7,125
20070225,19,1,10,0,3,0,34,2,69
20070226,70,5,32,6,14,1,120,19,267
20070227,72,12,33,1,13,1,103,13,248
20070228,66,9,28,3,13,0,102,12,233
20070301,64,11,29,1,4,0,94,12,215
20070302,62,3,25,2,10,0,107,15,224
20070303,40,4,22,2,5,0,68,6,147
20070304,23,3,5,1,1,0,34,3,70
20070305,64,9,27,1,6,1,114,6,228
20070306,107,17,26,6,14,1,151,16,338
20070307,82,7,26,0,6,3,93,24,241
20070308,68,9,25,1,5,0,105,11,224
20070309,78,12,37,1,11,0,105,14,258
20070310,51,8,16,5,8,0,87,14,189
20070311,23,1,12,1,3,0,38,1,79
20070312,90,6,32,2,9,0,122,11,272
20070313,97,12,36,1,9,0,121,19,295
20070314,72,12,30,2,10,0,107,19,252
20070315,86,15,33,4,5,1,121,13,278
20070316,89,9,28,2,5,1,105,18,257
20070317,56,5,13,2,6,1,93,12,188
20070318,27,2,6,1,5,1,26,5,73
20070319,65,8,30,5,9,1,107,17,242
20070320,96,6,26,5,8,1,110,17,269
20070321,103,13,25,3,10,0,134,18,306
20070322,98,12,27,4,12,1,117,18,289
20070323,81,9,26,3,10,1,112,13,255
20070324,52,6,18,1,6,0,72,7,162
20070325,21,6,8,1,2,0,38,5,81
20070326,61,5,24,1,6,0,103,17,217
20070327,91,7,23,4,10,2,117,16,270
20070328,87,6,27,5,13,1,117,21,277
20070329,54,8,22,1,7,0,93,14,199
20070330,85,9,30,4,7,1,108,15,259
20070331,47,7,20,1,8,2,80,16,181
20070401,29,3,8,2,5,0,41,7,95
20070402,83,8,34,5,5,1,112,12,260
20070403,89,9,21,2,7,0,108,14,250
20070404,97,15,26,7,12,1,124,23,305
20070405,79,7,22,0,12,0,120,11,251
20070406,25,6,7,3,4,0,29,9,83
20070407,52,4,22,3,4,0,61,8,154
20070408,22,3,6,1,0,0,25,4,61
20070409,79,4,22,1,6,2,126,14,254
20070410,109,13,36,5,7,1,115,25,311
20070411,76,8,18,2,16,0,113,12,245
20070412,78,7,28,5,6,1,113,13,251
20070413,76,17,29,5,10,1,118,16,272
20070414,47,6,16,3,7,0,85,17,181
20070415,24,3,8,1,3,0,36,0,75
20070416,65,5,30,2,5,2,128,25,262
20070417,116,17,27,4,10,2,167,17,360
20070418,87,9,28,3,5,2,137,13,284
20070419,103,10,36,3,6,0,160,26,344
20070420,75,7,16,1,9,0,100,18,226
20070421,30,4,12,5,4,0,57,3,115
20070422,16,2,7,0,3,1,25,3,57
20070423,40,2,10,4,5,1,68,10,140
20070424,92,13,41,5,11,1,157,23,343
20070425,90,14,36,0,12,0,143,19,314
20070426,100,8,28,7,20,1,153,15,332
20070427,53,3,31,3,7,0,90,17,204
20070428,53,6,11,1,5,0,94,14,184
20070429,13,3,4,0,1,0,33,5,59
20070430,60,11,30,3,9,0,107,9,229
20070501,30,3,12,0,2,0,44,6,97
20070502,63,4,23,0,7,0,96,8,201
20070503,67,10,27,4,6,1,111,16,242
20070504,91,12,34,3,12,0,104,20,276
20070505,43,7,12,2,4,0,55,9,132
20070506,19,3,13,1,4,1,30,3,74
20070507,71,9,31,2,11,4,103,10,241
20070508,84,12,32,5,15,0,127,13,288
20070509,75,7,27,1,17,0,118,14,259
20070510,73,2,35,4,10,0,106,13,243
20070511,80,12,25,0,4,1,88,13,223
20070512,56,6,16,4,3,0,80,12,177
20070513,12,1,10,0,3,1,26,4,57
20070514,59,12,18,1,6,0,122,9,227
20070515,68,13,37,6,6,2,110,16,258
20070516,105,8,38,3,6,2,138,12,312
20070517,100,9,27,4,9,1,121,15,286
20070518,91,9,28,2,8,1,100,10,249
20070519,50,4,22,3,6,2,69,9,165
20070520,20,0,11,1,6,1,27,4,70
20070521,72,13,28,5,6,1,116,15,256
20070522,69,8,24,2,7,0,109,15,234
20070523,60,17,28,4,10,0,121,12,252
20070524,66,5,16,4,5,1,116,9,222
20070525,77,5,17,1,4,1,88,20,213
20070526,46,5,17,4,7,0,62,10,151
20070527,18,5,5,1,3,0,26,2,60
20070528,72,12,22,4,16,1,85,10,222
20070529,83,6,20,1,13,0,129,18,270
20070530,54,6,23,3,5,3,101,13,208
20070531,74,6,32,4,15,0,141,22,294
20070601,55,6,22,3,10,0,82,13,191
20070602,42,4,17,1,2,0,50,7,123
20070603,26,2,6,2,0,1,21,2,60
20070604,49,9,14,2,4,0,66,12,156
20070605,56,8,18,2,6,0,77,10,177
20070606,70,9,18,1,5,3,84,13,203
20070607,18,0,7,0,1,0,32,4,62
20070608,73,7,25,6,6,0,98,8,223
20070609,37,1,19,1,2,0,56,7,123
20070610,20,0,3,0,0,0,30,6,59
20070611,49,10,18,2,4,1,79,13,176
20070612,71,15,23,3,6,5,101,11,235
20070613,78,7,28,3,8,2,100,12,238
20070614,73,12,29,3,12,2,142,13,286
20070615,85,10,38,4,9,3,140,16,305
20070616,57,5,14,4,10,0,90,15,195
20070617,25,4,5,2,2,0,38,6,82
20070618,82,7,35,3,12,2,138,16,295
20070619,89,11,32,6,13,1,136,24,312
20070620,82,6,24,8,3,0,121,20,264
20070621,112,16,38,8,16,1,152,21,364
20070622,124,8,49,2,12,2,154,21,372
20070623,63,5,15,2,6,0,74,16,181
20070624,21,3,10,0,0,0,24,4,62
20070625,80,5,36,2,6,1,104,15,249
20070626,100,20,37,4,7,1,149,20,338
20070627,88,17,32,4,9,0,159,17,326
20070628,79,8,21,2,5,0,127,13,255
20070629,86,13,39,3,7,2,138,18,306
20070630,60,4,16,1,11,0,60,6,158
20070701,21,4,12,3,2,0,40,4,86
20070702,92,17,35,1,12,3,140,17,317
20070703,104,9,40,3,7,2,166,18,349
20070704,112,13,32,5,10,0,157,17,346
20070705,115,8,47,4,4,1,156,25,360
20070706,100,5,33,2,8,1,139,21,309
20070707,69,6,18,2,9,0,101,10,215
20070708,26,2,9,1,1,0,34,4,77
20070709,95,14,34,2,12,0,144,21,322
20070710,149,21,60,10,14,2,160,23,439
20070711,107,4,25,1,16,3,174,18,348
20070712,76,18,36,1,10,1,132,14,288
20070713,86,8,35,2,15,1,92,11,250
20070714,57,10,21,3,4,1,83,13,192
20070715,28,7,13,2,2,0,42,7,101
20070716,89,8,35,3,14,0,122,15,286
20070717,88,10,38,2,8,1,109,18,274
20070718,113,9,40,6,14,2,151,26,361
20070719,111,13,45,4,13,0,179,28,393
20070720,175,24,62,4,16,3,242,25,551
20070721,94,11,29,7,16,0,147,20,324
20070722,35,1,11,2,1,1,57,3,111
20070723,141,9,45,6,12,3,185,28,429
20070724,115,10,49,9,14,2,203,21,423
20070725,116,16,38,3,10,0,146,18,347
20070726,93,7,41,2,11,2,158,20,334
20070727,117,12,42,4,13,3,138,21,350
20070728,63,8,19,2,8,1,79,9,189
20070729,26,1,6,1,1,0,27,4,66
20070730,57,7,25,2,8,2,112,11,224
20070731,92,14,32,5,17,1,116,18,295
20070801,80,11,30,2,6,1,124,20,274
20070802,89,10,32,5,11,0,151,22,320
20070803,77,5,24,5,17,0,104,18,250
20070804,44,6,10,2,3,0,62,8,135
20070805,17,4,11,0,5,1,34,6,78
20070806,73,10,25,2,10,0,111,13,244
20070807,100,11,35,2,10,0,114,20,292
20070808,116,9,41,7,13,0,170,16,372
20070809,109,10,34,4,13,0,118,12,300
20070810,89,8,47,6,12,1,107,18,288
20070811,50,5,18,1,3,0,65,13,155
20070812,20,3,2,1,1,0,16,7,50
20070813,81,8,28,3,5,3,106,16,250
20070814,105,13,35,7,12,0,132,25,329
20070815,82,17,36,4,10,1,130,24,304
20070816,104,13,23,5,9,2,139,14,309
20070817,93,9,40,6,8,0,143,25,324
20070818,65,8,11,2,7,0,82,16,191
20070819,23,1,4,0,2,0,21,2,53
20070820,81,15,37,4,6,1,115,15,274
20070821,93,13,33,2,10,0,147,8,306
20070822,67,7,31,2,10,3,120,19,259
20070823,77,9,30,7,7,1,101,10,242
20070824,69,5,22,3,13,0,104,14,230
20070825,58,5,18,1,4,0,60,19,165
20070826,40,8,15,0,4,1,81,10,159
20070827,72,7,20,7,7,2,96,8,219
20070828,84,14,37,3,11,2,122,20,293
20070829,71,14,43,4,8,1,133,14,288
20070830,79,4,27,1,6,2,103,13,235
20070831,80,6,33,3,9,0,95,11,237
20070901,64,7,24,2,9,1,117,14,238
20070902,21,2,10,0,1,0,22,3,59
20070903,67,10,24,3,8,1,109,14,236
20070904,81,6,29,1,8,0,111,21,257
20070905,76,8,25,1,7,1,130,13,261
20070906,68,0,43,2,10,1,109,14,247
20070907,32,4,13,1,0,0,35,7,92
20070908,49,3,13,0,2,0,72,5,144
20070909,7,1,5,1,1,1,16,4,36
20070910,94,13,24,2,13,0,113,12,271
20070911,79,12,34,3,8,2,103,15,256
20070912,78,8,22,3,10,0,111,14,246
20070913,91,5,33,3,7,0,111,23,273
20070914,75,8,26,2,12,2,104,16,245
20070915,43,5,16,1,3,0,52,7,127
20070916,13,2,7,1,2,0,20,12,57
20070917,57,9,34,3,7,1,108,11,230
20070918,124,8,41,3,8,0,125,20,329
20070919,103,9,44,7,17,2,148,23,353
20070920,84,10,27,4,10,0,108,21,264
20070921,100,11,29,4,6,0,113,16,279
20070922,65,4,25,1,3,2,65,12,177
20070923,45,4,18,1,6,0,56,6,136
20070924,74,9,34,7,5,2,142,17,290
20070925,85,7,30,3,9,2,150,16,302
20070926,88,15,32,4,9,2,162,19,331
20070927,109,16,41,8,13,1,140,17,345
20070928,87,11,39,6,19,4,131,31,328
20070929,89,7,34,1,14,2,107,15,269
20070930,32,3,10,3,2,0,30,5,85
20071001,86,8,44,4,9,1,131,23,306
20071002,90,9,36,2,10,0,134,19,300
20071003,67,8,31,2,12,1,131,18,270
20071004,80,8,33,5,11,1,115,17,270
20071005,125,13,28,6,7,0,130,14,323
20071006,52,7,16,1,7,1,86,20,190
20071007,16,1,12,0,3,0,26,3,61
20071008,95,11,35,1,12,0,122,8,284
20071009,119,17,30,3,10,2,139,16,336
20071010,83,16,45,5,10,3,128,22,312
20071011,70,5,30,2,7,0,117,22,253
20071012,24,1,9,1,0,0,45,4,84
20071013,53,7,19,0,2,0,80,11,172
20071014,16,3,6,2,6,0,23,4,60
20071015,82,10,34,5,9,2,120,17,279
20071016,70,14,22,2,10,0,110,19,247
20071017,91,19,27,5,10,1,124,22,299
20071018,74,15,27,2,11,1,110,16,256
20071019,103,11,34,6,11,1,122,25,313
20071020,63,7,31,1,5,0,79,12,198
20071021,13,3,11,1,4,0,31,3,66
20071022,81,6,36,2,8,1,113,10,257
20071023,98,11,42,1,16,2,131,12,313
20071024,62,5,19,3,8,1,61,6,165
20071025,86,10,20,3,13,1,81,14,228
20071026,59,8,29,2,5,2,113,16,234
20071027,79,7,15,0,7,0,90,18,216
20071028,15,4,9,1,1,0,26,4,60
20071029,60,9,30,3,2,1,114,11,230
20071030,59,3,38,1,6,1,97,6,211
20071031,62,8,36,2,3,2,94,17,224
20071101,64,10,25,1,6,1,113,21,241
20071102,40,0,9,5,5,0,35,8,102
20071103,43,5,10,2,5,0,55,4,124
20071104,17,2,7,1,1,0,22,2,52
20071105,76,5,34,6,5,0,112,10,248
20071106,98,11,32,1,13,0,140,24,319
20071107,56,6,32,6,11,1,113,13,238
20071108,69,5,36,1,9,1,114,16,251
20071109,118,11,26,1,6,0,158,13,333
20071110,58,5,26,0,8,0,82,10,189
20071111,17,2,4,1,5,2,21,2,54
20071112,80,12,36,5,13,0,111,11,268
20071113,81,11,39,1,8,1,109,19,269
20071114,66,5,28,3,11,2,85,10,210
20071115,28,8,6,2,3,0,40,5,92
20071116,75,6,21,1,10,0,92,29,234
20071117,48,4,14,0,5,0,67,10,148
20071118,29,1,3,0,3,0,31,7,74
20071119,79,7,30,3,8,0,135,14,276
20071120,52,5,23,3,9,0,68,8,168
20071121,91,8,34,4,12,0,119,17,285
20071122,79,6,30,4,12,1,123,20,275
20071123,93,11,28,2,12,1,114,18,279
20071124,89,8,31,3,12,1,123,19,286
20071125,69,12,25,0,4,2,119,20,251
20071126,95,15,35,5,8,1,150,31,340
20071127,112,10,46,1,14,1,190,22,396
20071128,95,15,28,6,15,2,146,23,330
20071129,118,21,45,3,10,0,199,24,420
20071130,87,13,21,1,4,0,159,18,303
20071201,52,2,14,1,4,2,76,11,162
20071202,26,6,9,2,2,0,44,4,93
20071203,81,8,33,4,12,0,168,12,318
20071204,85,13,40,2,10,1,97,11,259
20071205,73,8,32,2,10,0,103,23,251
20071206,71,7,23,1,5,0,125,17,249
20071207,103,9,33,2,7,0,131,14,299
20071208,49,6,26,1,9,1,88,9,189
20071209,20,2,12,1,3,0,27,7,72
20071210,85,10,24,3,8,0,112,20,262
20071211,98,17,34,4,12,1,145,24,335
20071212,64,4,17,4,8,1,101,15,214
20071213,65,6,18,4,7,1,91,11,203
20071214,63,5,18,4,7,2,68,11,178
20071215,31,4,12,1,5,1,67,5,126
20071216,21,0,8,1,4,1,31,6,72
20071217,73,7,26,2,5,0,108,17,238
20071218,71,6,33,2,13,1,115,14,255
20071219,54,10,17,2,4,1,88,14,190
20071220,68,7,17,4,6,2,90,9,203
20071221,59,5,14,3,5,0,92,11,189
20071222,50,7,16,0,8,0,74,6,161
20071223,24,3,15,0,0,0,38,4,84
20071224,27,7,15,0,4,0,52,7,112
20071225,9,3,3,1,1,0,6,3,26
20071226,81,5,17,4,9,2,101,9,228
20071227,116,18,42,4,8,0,131,18,337
20071228,103,13,32,4,8,1,156,22,339
20071229,73,7,23,0,8,0,83,10,204
20071230,32,4,8,0,3,0,55,6,108
20071231,64,6,19,3,8,0,100,14,214
20080101,0,0,0,0,0,0,0,0,0
20080102,81,9,23,3,7,2,94,16,235
20080103,73,10,32,5,8,4,121,8,261
20080104,88,9,29,5,6,0,103,22,262
20080105,69,7,18,1,8,0,79,12,194
20080106,33,4,13,2,1,1,37,6,97
20080107,109,3,40,6,9,0,138,19,324
20080108,129,15,34,2,15,3,148,20,366
20080109,99,16,37,3,4,1,132,18,310
20080110,105,5,44,0,9,0,131,13,307
20080111,84,5,29,5,19,0,136,17,295
20080112,77,1,24,0,4,1,81,8,196
20080113,21,2,9,1,1,1,35,4,74
20080114,91,10,39,5,9,1,139,24,318
20080115,122,9,44,11,12,2,152,22,374
20080116,113,15,43,6,7,1,185,15,385
20080117,113,17,31,2,9,0,122,21,315
20080118,91,15,40,5,10,1,159,21,342
20080119,92,10,44,5,4,2,150,16,323
20080120,63,10,26,3,6,0,81,7,196
20080121,91,14,30,4,7,1,120,8,275
20080122,74,13,40,3,7,1,162,17,317
20080123,84,12,33,6,4,0,107,17,263
20080124,109,15,32,4,12,2,131,17,322
20080125,103,16,32,4,8,3,155,16,337
20080126,99,17,40,3,15,1,162,22,359
20080127,43,5,9,0,1,1,49,5,113
20080128,125,14,44,4,16,2,190,17,412
20080129,119,12,52,5,15,0,163,16,382
20080130,138,16,47,2,12,0,177,26,418
20080131,131,19,49,2,20,3,191,32,447
20080201,98,13,32,7,16,2,160,35,363
20080202,49,8,21,1,6,1,90,14,190
20080203,9,0,16,1,1,0,15,4,46
20080204,40,8,24,3,4,1,53,5,138
20080205,20,2,9,0,3,0,39,6,79
20080206,26,5,17,6,5,0,56,3,118
20080207,88,4,31,1,8,1,121,17,271
20080208,85,7,40,5,16,0,124,23,300
20080209,50,6,31,2,12,0,69,5,175
20080210,43,4,18,1,6,0,52,5,129
20080211,93,10,31,3,14,2,131,12,296
20080212,82,7,40,4,8,0,139,17,297
20080213,88,11,19,1,13,0,128,28,288
20080214,90,17,27,3,11,0,161,19,328
20080215,103,12,36,7,11,2,151,16,338
20080216,81,11,26,1,3,1,86,14,223
20080217,27,4,4,0,2,0,37,1,75
20080218,83,7,26,6,8,1,143,17,291
20080219,81,8,39,7,9,2,119,9,274
20080220,109,9,38,2,15,2,153,15,343
20080221,94,12,26,4,12,2,140,16,306
20080222,65,9,32,1,11,1,129,19,267
20080223,59,7,34,1,11,0,78,12,202
20080224,19,2,14,1,4,1,41,8,90
20080225,84,17,48,5,15,0,122,19,310
20080226,123,12,37,5,11,2,152,13,355
20080227,115,9,34,7,14,0,144,20,343
20080228,85,14,35,4,7,3,143,19,310
20080229,98,12,39,5,10,2,158,25,349
20080301,53,6,21,0,5,0,82,18,185
20080302,26,2,12,0,5,0,32,6,83
20080303,82,14,30,1,6,0,131,14,278
20080304,88,13,30,3,14,2,172,12,334
20080305,111,19,39,3,24,2,150,25,373
20080306,104,12,39,6,16,2,135,29,343
20080307,74,8,30,4,8,2,121,12,259
20080308,59,7,21,0,7,0,77,11,182
20080309,49,6,14,3,7,0,56,7,142
20080310,101,9,31,4,13,3,132,13,306
20080311,137,17,48,4,17,2,191,24,440
20080312,123,10,40,0,15,1,181,24,394
20080313,88,21,33,7,14,1,172,16,352
20080314,94,10,30,5,10,0,157,16,322
20080315,79,7,22,2,5,0,90,9,214
20080316,35,1,7,1,5,0,34,5,88
20080317,85,10,37,4,7,0,140,17,300
20080318,111,9,28,1,11,0,153,17,330
20080319,103,8,36,7,9,0,168,24,355
20080320,121,16,44,7,4,1,154,27,374
20080321,112,8,38,9,20,2,166,30,385
20080322,132,21,33,4,18,0,139,27,374
20080323,66,11,33,4,4,3,93,14,228
20080324,144,15,67,7,16,3,244,28,524
20080325,204,23,63,10,24,2,272,33,631
20080326,166,13,73,6,21,3,233,36,551
20080327,208,22,86,9,23,2,318,36,704
20080328,187,21,70,11,19,1,294,37,640
20080329,172,25,60,7,20,0,252,27,563
20080330,89,10,37,4,8,2,147,21,318
20080331,201,21,73,5,21,0,284,31,636
20080401,174,16,70,8,18,0,301,33,620
20080402,189,23,62,7,22,4,264,38,609
20080403,191,22,67,4,12,2,278,36,612
20080404,176,19,66,7,13,1,236,14,532
20080405,149,23,54,5,14,2,217,22,486
20080406,79,12,20,2,6,2,103,15,239
20080407,157,25,57,8,27,4,220,33,531
20080408,147,17,59,10,18,0,222,34,507
20080409,166,22,66,11,18,1,242,27,553
20080410,167,21,61,7,13,1,209,27,506
20080411,152,20,52,8,15,1,221,24,493
20080412,131,8,47,7,16,3,181,26,419
20080413,53,3,14,4,7,2,67,10,160
20080414,160,18,60,5,12,6,225,34,520
20080415,115,10,38,8,19,1,174,25,390
20080416,135,21,56,6,19,1,184,27,449
20080417,111,12,47,2,14,0,195,28,409
20080418,113,10,54,4,16,2,193,24,416
20080419,86,13,38,4,12,0,125,17,295
20080420,60,4,21,2,6,0,66,6,165
20080421,67,9,27,1,6,0,100,5,215
20080422,126,15,52,5,16,2,172,21,409
20080423,84,7,35,4,8,1,117,16,272
20080424,115,11,42,2,14,4,187,20,395
20080425,103,18,61,5,15,1,155,20,378
20080426,108,11,41,5,17,0,116,21,319
20080427,58,8,13,5,5,1,88,7,185
20080428,122,12,57,4,11,2,177,18,403
20080429,137,20,56,6,18,1,205,21,464
20080430,120,10,37,2,11,0,149,14,343
20080501,50,5,13,0,8,0,60,3,139
20080502,109,10,57,8,23,2,215,23,447
20080503,50,9,17,4,2,0,68,6,156
20080504,32,6,12,2,4,0,41,6,103
20080505,102,14,38,0,19,0,161,21,355
20080506,112,10,46,3,15,2,167,20,375
20080507,126,17,38,4,11,3,172,21,392
20080508,103,16,31,3,16,1,146,31,347
20080509,100,14,33,5,13,2,156,19,342
20080510,76,11,31,4,11,2,111,15,261
20080511,22,2,7,1,0,0,22,0,54
20080512,121,5,42,3,17,1,157,16,362
20080513,98,12,46,2,12,3,164,16,353
20080514,119,13,37,8,7,2,158,17,361
20080515,94,16,38,2,6,4,150,23,333
20080516,83,6,38,5,5,1,120,16,274
20080517,83,9,31,2,12,0,115,11,263
20080518,30,4,9,0,6,1,29,7,86
20080519,112,11,27,4,13,2,175,23,367
20080520,98,11,33,2,9,2,124,12,291
20080521,95,8,30,6,12,0,132,15,298
20080522,23,7,5,0,0,0,34,7,76
20080523,83,10,34,1,9,0,123,18,278
20080524,71,4,33,1,9,1,94,13,226
20080525,30,0,10,1,3,1,51,8,104
20080526,115,11,39,1,18,1,143,22,350
20080527,141,18,48,8,10,1,173,17,416
20080528,100,18,28,5,7,2,115,25,300
20080529,106,7,45,1,14,2,145,24,344
20080530,106,9,28,2,13,1,124,12,295
20080531,76,4,34,5,10,0,123,20,272
20080601,15,0,6,1,2,0,32,6,62
20080602,82,7,26,7,5,0,91,6,224
20080603,65,9,20,0,7,0,93,14,208
20080604,92,9,29,2,16,0,110,18,276
20080605,64,10,30,4,11,3,102,19,243
20080606,78,6,17,2,4,1,110,8,226
20080607,45,8,28,3,6,0,73,11,174
20080608,16,0,2,0,1,0,22,2,43
20080609,85,11,40,3,19,1,115,11,285
20080610,70,9,30,4,7,0,96,15,231
20080611,82,10,25,2,8,2,77,14,220
20080612,98,7,34,1,14,3,131,13,301
20080613,78,7,35,6,7,0,91,12,236
20080614,62,5,25,2,4,1,84,7,190
20080615,12,2,8,0,2,0,18,3,45
20080616,77,9,25,2,4,0,89,10,216
20080617,114,13,36,6,8,1,147,18,343
20080618,82,5,27,3,10,2,133,8,270
20080619,92,8,30,3,8,0,110,20,271
20080620,81,9,27,3,13,0,106,14,253
20080621,42,4,22,4,5,1,86,9,173
20080622,16,3,12,0,2,1,30,5,69
20080623,72,8,33,4,5,0,102,15,239
20080624,64,7,14,2,3,0,89,13,192
20080625,83,5,30,0,3,0,99,13,233
20080626,70,13,21,5,7,1,129,22,268
20080627,55,7,22,2,4,1,92,10,193
20080628,80,12,27,4,7,0,123,18,271
20080629,45,3,13,2,5,1,42,6,117
20080630,96,5,31,2,6,2,115,9,266
20080701,61,5,20,4,6,4,84,14,198
20080702,68,4,25,3,6,0,103,15,224
20080703,85,8,30,2,10,2,115,18,270
20080704,57,6,15,1,7,0,82,5,173
20080705,72,8,23,3,13,0,114,10,243
20080706,15,0,11,0,2,1,31,5,65
20080707,88,11,28,1,10,1,119,12,270
20080708,77,8,30,4,15,1,110,26,271
20080709,74,7,26,3,6,0,134,23,273
20080710,93,11,41,6,6,3,145,27,332
20080711,63,12,28,3,12,0,117,6,241
20080712,76,4,25,5,18,2,107,7,244
20080713,15,0,6,1,1,0,33,3,59
20080714,67,5,34,2,13,0,97,10,228
20080715,88,10,32,3,8,1,103,21,266
20080716,97,4,29,6,13,3,107,15,274
20080717,114,10,27,6,9,4,144,14,328
20080718,69,11,27,5,5,0,112,9,238
20080719,63,8,27,4,9,2,90,15,218
20080720,24,3,8,1,2,0,30,20,88
20080721,70,13,33,2,9,0,96,10,233
20080722,86,7,28,2,17,1,153,14,308
20080723,94,10,30,6,5,0,130,20,295
20080724,96,12,29,4,9,0,126,15,291
20080725,74,11,35,0,7,1,125,16,269
20080726,66,8,22,7,8,0,85,13,209
20080727,24,5,10,1,5,0,53,6,104
20080728,77,16,43,4,12,1,127,10,290
20080729,100,13,50,4,8,2,160,22,359
20080730,70,9,30,2,11,0,118,18,258
20080731,105,8,45,8,10,0,144,14,334
20080801,81,9,28,3,8,1,113,19,262
20080802,48,5,11,1,2,0,64,7,138
20080803,23,3,14,4,3,0,42,6,95
20080804,77,9,38,3,8,1,125,14,275
20080805,88,16,37,2,17,4,133,15,312
20080806,91,9,35,5,6,3,119,12,280
20080807,103,17,51,2,12,2,140,21,348
20080808,84,12,37,3,9,1,142,24,312
20080809,61,9,16,1,6,1,82,12,188
20080810,25,1,9,2,4,0,29,3,73
20080811,78,2,31,8,5,2,122,20,268
20080812,100,14,24,3,9,0,129,13,292
20080813,73,12,24,3,6,0,102,16,236
20080814,82,12,29,5,5,0,128,16,277
20080815,66,8,21,2,5,0,104,14,220
20080816,62,8,17,4,6,0,75,9,181
20080817,27,3,5,0,3,0,37,8,83
20080818,59,7,19,3,5,0,86,11,190
20080819,75,6,28,3,7,2,113,16,250
20080820,74,7,25,3,12,0,121,13,255
20080821,107,11,31,4,4,1,150,24,332
20080822,101,9,34,8,11,2,145,21,331
20080823,53,7,15,1,8,1,66,17,168
20080824,29,3,8,1,2,0,25,4,72
20080825,94,9,30,3,11,1,112,17,277
20080826,77,9,29,3,12,0,102,21,253
20080827,70,11,38,2,10,2,117,16,266
20080828,79,9,20,4,10,0,136,20,278
20080829,63,11,25,3,6,1,87,13,209
20080830,92,5,26,1,6,0,106,18,254
20080831,18,3,9,3,6,0,48,6,93
20080901,95,11,34,1,14,1,111,19,286
20080902,74,9,24,4,15,1,102,13,242
20080903,68,4,17,1,5,1,91,18,205
20080904,72,5,13,0,9,2,81,15,197
20080905,60,5,26,1,2,0,103,10,207
20080906,42,5,9,2,3,1,52,11,125
20080907,9,1,9,0,3,0,15,5,42
20080908,42,7,36,3,6,1,80,16,191
20080909,65,3,21,3,8,0,114,13,227
20080910,79,10,25,3,11,3,106,20,257
20080911,74,9,25,1,11,1,123,9,253
20080912,74,13,32,3,12,1,117,18,270
20080913,32,4,11,0,4,1,55,5,112
20080914,19,4,2,0,0,0,20,5,50
20080915,54,9,23,0,10,0,93,9,198
20080916,53,7,17,2,11,1,79,12,182
20080917,67,7,24,1,8,0,90,14,211
20080918,49,12,26,1,6,0,94,17,205
20080919,79,12,25,2,8,2,115,20,263
20080920,30,2,12,1,3,1,47,8,104
20080921,18,2,7,1,1,0,27,5,61
20080922,88,5,27,2,10,1,100,17,250
20080923,73,13,22,2,5,1,108,10,234
20080924,86,12,31,4,12,0,131,15,291
20080925,95,16,42,5,15,2,137,19,331
20080926,55,11,17,3,9,6,97,14,212
20080927,76,9,27,1,5,1,106,17,242
20080928,22,3,6,0,5,0,24,6,66
20080929,80,8,24,4,6,1,107,8,238
20080930,65,8,35,6,10,1,102,8,235
20081001,75,10,18,4,5,0,100,14,226
20081002,61,5,27,3,8,1,87,18,210
20081003,68,6,17,3,9,1,83,7,194
20081004,46,3,18,4,11,1,77,8,168
20081005,17,3,7,0,1,0,14,3,45
20081006,92,13,34,1,7,1,123,10,281
20081007,77,9,22,4,6,3,105,14,240
20081008,90,13,25,5,11,1,115,6,266
20081009,79,6,34,2,10,1,118,10,260
20081010,87,10,48,4,6,3,122,20,300
20081011,71,15,18,3,5,0,76,9,197
20081012,17,3,5,2,2,0,32,2,63
20081013,69,13,44,1,8,0,102,14,251
20081014,90,12,22,3,9,0,111,19,266
20081015,86,11,36,8,12,0,129,18,300
20081016,74,15,27,3,1,0,100,21,241
20081017,87,11,31,1,16,2,98,13,259
20081018,85,6,22,5,10,1,119,13,261
20081019,26,2,7,0,5,0,29,8,77
20081020,112,9,34,3,9,3,135,16,321
20081021,93,15,31,3,13,2,160,18,335
20081022,93,12,37,4,10,0,133,17,306
20081023,109,10,52,2,11,3,157,15,359
20081024,62,6,34,1,15,0,105,10,233
20081025,79,7,24,1,8,0,101,10,230
20081026,18,0,9,0,2,0,11,3,43
20081027,64,8,24,3,7,1,92,13,212
20081028,86,8,39,3,9,0,135,24,304
20081029,85,11,36,3,5,3,117,16,276
20081030,82,12,21,2,12,0,90,19,238
20081031,108,13,37,5,17,3,139,20,342
20081101,76,5,16,0,10,2,92,12,213
20081102,12,2,7,0,2,0,14,8,45
20081103,76,10,19,2,6,0,101,12,226
20081104,76,12,31,4,7,3,106,18,257
20081105,113,7,44,4,5,2,132,16,323
20081106,70,9,23,2,5,1,113,11,234
20081107,69,7,25,2,11,0,115,16,245
20081108,42,5,19,2,4,0,79,14,165
20081109,19,1,6,2,1,0,37,6,72
20081110,82,9,24,6,13,1,122,14,271
20081111,81,6,40,1,7,3,110,14,262
20081112,75,9,29,1,12,4,115,15,260
20081113,72,15,31,4,9,0,117,14,262
20081114,98,10,34,4,11,1,135,27,320
20081115,29,2,12,2,4,0,45,7,101
20081116,10,1,4,2,1,0,11,3,32
20081117,82,14,31,2,9,3,131,15,287
20081118,75,4,26,2,11,1,116,18,253
20081119,55,6,21,1,4,2,78,11,178
20081120,30,2,9,0,1,0,45,7,94
20081121,69,8,25,4,5,1,98,13,223
20081122,74,7,34,2,7,0,85,15,224
20081123,23,3,7,1,2,0,26,4,66
20081124,92,13,24,6,11,0,115,19,280
20081125,194,18,72,8,21,2,311,38,664
20081126,90,8,31,0,10,0,146,17,302
20081127,107,12,51,7,12,1,163,14,367
20081128,97,14,24,2,15,1,165,23,341
20081129,92,13,36,3,12,0,117,15,288
20081130,39,5,7,2,6,0,45,10,114
20081201,66,5,23,3,11,0,117,20,245
20081202,65,9,27,2,3,1,110,18,235
20081203,102,13,30,3,6,3,135,16,308
20081204,83,9,24,4,10,1,95,19,245
20081205,117,10,36,3,14,0,118,16,314
20081206,37,4,18,1,6,0,81,8,155
20081207,28,3,4,0,4,0,26,3,68
20081208,107,8,32,4,11,1,130,21,314
20081209,84,10,19,3,8,1,125,23,273
20081210,53,3,18,3,5,1,104,9,196
20081211,78,11,26,1,11,4,134,17,282
20081212,59,6,33,0,9,1,80,7,195
20081213,43,2,17,4,3,2,74,17,162
20081214,30,3,10,2,3,0,33,3,84
20081215,69,6,23,3,7,2,85,14,209
20081216,59,8,21,5,9,0,78,17,197
20081217,55,4,14,3,5,1,80,6,168
20081218,63,5,15,6,8,1,119,21,238
20081219,55,6,21,2,10,0,104,16,214
20081220,29,5,8,0,5,0,43,5,95
20081221,18,3,4,1,0,0,20,1,47
20081222,64,8,19,4,7,2,72,14,190
20081223,50,10,29,2,5,1,75,14,186
20081224,36,1,14,4,2,0,49,8,114
20081225,18,3,4,0,1,0,10,4,40
20081226,49,10,12,3,9,1,57,8,149
20081227,38,2,15,1,5,0,47,11,119
20081228,21,2,6,1,1,1,25,4,61
20081229,86,10,35,3,10,2,116,16,278
20081230,110,6,28,4,12,1,125,30,316
20081231,98,15,31,3,12,0,136,22,317
20090101,0,0,0,0,0,0,0,0,0
20090102,61,8,23,1,11,1,130,23,258
20090103,72,2,27,8,4,0,78,17,208
20090104,10,3,4,1,2,0,29,3,52
20090105,80,7,34,4,12,1,145,16,299
20090106,62,6,16,3,4,2,99,8,200
20090107,94,15,25,4,12,1,136,16,303
20090108,107,3,38,4,8,0,131,18,309
20090109,98,14,27,9,14,0,150,24,336
20090110,60,8,25,1,6,1,86,12,199
20090111,18,1,4,0,1,0,31,2,57
20090112,84,13,32,3,12,3,132,12,291
20090113,69,5,35,3,9,0,123,17,261
20090114,61,5,27,5,9,0,105,11,223
20090115,79,12,28,1,11,1,99,23,254
20090116,58,6,26,2,10,0,110,19,231
20090117,40,6,19,3,5,0,75,9,157
20090118,13,0,2,0,1,0,18,3,37
20090119,99,13,35,4,11,1,149,26,338
20090120,46,4,18,3,2,0,68,11,152
20090121,57,3,28,3,3,2,97,14,207
20090122,62,5,25,0,11,0,110,12,225
20090123,86,14,40,6,11,0,128,21,306
20090124,59,6,12,2,3,1,74,8,165
20090125,32,5,7,0,4,1,50,6,105
20090126,80,5,37,4,14,4,124,19,287
20090127,96,13,44,7,8,1,138,18,325
20090128,71,11,27,2,10,1,120,21,263
20090129,95,7,29,8,7,2,122,19,289
20090130,91,9,24,4,10,0,115,11,264
20090131,87,13,24,5,4,1,125,18,277
20090201,18,1,10,5,0,0,28,5,67
20090202,71,8,34,4,8,3,118,17,263
20090203,89,6,31,4,12,0,131,18,291
20090204,71,8,32,3,8,0,101,21,244
20090205,75,8,35,2,11,1,119,13,264
20090206,78,9,29,3,7,2,131,19,278
20090207,53,7,20,3,7,0,74,10,174
20090208,28,5,11,0,6,1,37,10,98
20090209,103,9,34,6,9,2,149,28,340
20090210,88,9,29,6,6,0,115,15,268
20090211,81,8,20,5,15,2,119,13,263
20090212,90,10,35,4,6,2,111,15,273
20090213,76,5,29,4,6,1,100,18,239
20090214,58,4,17,0,7,1,78,12,177
20090215,32,2,7,0,1,1,42,9,94
20090216,96,15,30,5,9,1,154,12,322
20090217,76,11,43,6,10,3,142,24,315
20090218,116,17,40,4,13,1,179,28,398
20090219,115,12,39,3,8,2,174,29,382
20090220,105,11,45,3,8,1,168,18,359
20090221,33,3,16,3,2,0,65,10,132
20090222,15,2,3,0,0,0,11,4,35
20090223,41,4,9,0,6,1,51,5,117
20090224,15,5,5,1,3,1,31,5,66
20090225,57,5,24,4,6,0,69,13,178
20090226,69,8,21,3,6,0,96,5,208
20090227,84,10,25,3,3,1,110,19,255
20090228,49,3,8,0,5,0,69,8,142
20090301,15,0,9,2,4,0,29,3,62
20090302,75,12,30,2,8,1,125,19,272
20090303,88,19,34,5,16,1,140,20,323
20090304,82,7,24,4,7,0,121,14,259
20090305,76,8,18,2,8,2,105,10,229
20090306,94,6,40,3,7,0,104,19,273
20090307,86,4,30,3,9,0,101,18,251
20090308,12,7,11,2,3,0,29,6,70
20090309,78,7,30,4,9,2,123,15,268
20090310,88,16,32,5,6,0,138,12,297
20090311,101,5,31,3,12,1,163,22,338
20090312,118,15,33,3,10,2,139,19,339
20090313,121,8,26,5,12,1,160,16,349
20090314,36,3,21,4,1,0,61,10,136
20090315,15,1,9,0,1,0,31,5,62
20090316,90,8,34,2,5,0,136,19,294
20090317,123,8,50,7,18,2,146,23,377
20090318,99,9,24,1,11,1,130,19,294
20090319,101,15,41,1,4,3,129,16,310
20090320,104,11,28,4,10,1,126,18,302
20090321,43,1,9,3,6,1,54,8,125
20090322,20,2,5,1,0,1,20,7,56
20090323,68,6,23,5,12,1,114,11,240
20090324,88,11,33,4,10,1,122,12,281
20090325,60,7,42,1,11,0,126,15,262
20090326,134,17,39,0,11,1,140,21,363
20090327,101,11,40,0,10,2,114,21,299
20090328,65,5,27,5,7,0,123,14,246
20090329,43,6,14,1,5,0,61,7,137
20090330,58,4,34,2,9,0,97,23,227
20090331,75,5,23,1,11,0,124,18,257
20090401,76,8,33,5,12,1,124,14,273
20090402,100,11,24,4,14,1,141,17,312
20090403,67,5,29,3,6,2,97,12,221
20090404,62,17,21,2,10,0,79,12,203
20090405,21,5,3,1,5,0,25,6,66
20090406,68,7,22,3,4,0,95,11,210
20090407,53,12,17,1,9,0,87,17,196
20090408,70,6,18,4,8,0,97,11,214
20090409,63,14,22,1,8,0,83,13,204
20090410,32,3,13,0,5,0,49,6,108
20090411,45,5,17,2,4,0,63,9,145
20090412,21,1,7,2,2,0,21,7,61
20090413,73,10,19,2,8,2,118,17,249
20090414,100,7,33,4,12,0,150,12,318
20090415,54,3,14,1,8,1,90,7,178
20090416,70,7,20,3,6,0,83,6,195
20090417,66,6,28,3,11,1,107,9,231
20090418,55,8,20,2,9,0,79,10,183
20090419,29,1,9,0,1,0,63,8,111
20090420,85,10,38,5,9,0,153,15,315
20090421,47,7,25,1,6,3,74,15,178
20090422,72,6,41,2,9,2,139,29,300
20090423,65,2,23,5,5,0,100,13,213
20090424,97,11,30,1,11,1,135,31,317
20090425,74,7,23,2,6,2,105,15,234
20090426,29,3,6,0,2,0,37,6,83
20090427,109,10,43,4,12,2,151,16,347
20090428,105,10,41,4,12,1,158,26,357
20090429,114,11,46,4,13,1,186,12,387
20090430,120,12,50,8,18,0,171,17,396
20090501,42,6,21,0,6,0,72,6,153
20090502,30,8,21,1,3,3,70,7,143
20090503,19,1,9,3,8,0,34,7,81
20090504,83,16,32,7,6,1,121,23,289
20090505,99,13,33,3,10,2,115,11,286
20090506,89,21,30,4,8,2,150,26,330
20090507,98,15,39,9,8,1,167,13,350
20090508,73,6,33,3,7,4,119,25,270
20090509,49,3,14,2,10,1,62,11,152
20090510,24,0,3,0,0,0,13,0,40
20090511,70,8,32,5,5,0,110,19,249
20090512,76,5,43,3,7,1,111,25,271
20090513,60,11,24,7,10,1,103,16,232
20090514,107,15,35,3,11,1,111,19,302
20090515,97,13,35,1,12,2,140,22,322
20090516,60,6,23,1,2,0,76,14,182
20090517,27,7,8,0,7,0,43,10,102
20090518,78,12,28,3,10,2,121,24,278
20090519,94,11,40,5,8,2,135,21,316
20090520,102,10,31,4,10,1,119,15,292
20090521,93,8,38,4,4,1,124,17,289
20090522,86,12,36,6,7,0,140,24,311
20090523,58,6,20,3,3,1,77,16,184
20090524,22,4,6,0,2,0,18,4,56
20090525,76,6,24,1,9,0,117,10,243
20090526,104,9,31,3,11,1,151,21,331
20090527,91,10,40,3,14,0,147,21,326
20090528,101,9,44,2,6,2,128,21,313
20090529,59,11,22,0,2,2,105,13,214
20090530,77,8,31,1,6,0,102,9,234
20090531,23,3,7,0,2,0,29,5,69
20090601,51,2,27,3,5,0,84,15,187
20090602,52,9,26,0,3,1,93,13,197
20090603,67,7,19,3,5,0,92,19,212
20090604,58,2,22,2,5,0,62,6,157
20090605,56,7,17,2,4,0,85,8,179
20090606,40,6,16,4,5,1,66,8,146
20090607,12,2,4,0,2,0,23,6,49
20090608,62,7,20,1,9,1,88,15,203
20090609,77,10,25,4,9,1,97,13,236
20090610,75,5,26,2,9,0,107,23,247
20090611,36,9,14,2,9,0,63,8,141
20090612,84,14,30,4,14,2,131,24,303
20090613,69,8,19,3,10,2,94,11,216
20090614,55,4,23,2,8,1,59,16,168
20090615,86,6,30,2,8,0,136,11,279
20090616,72,7,30,2,12,0,124,15,262
20090617,108,11,36,3,12,1,160,22,353
20090618,132,15,51,4,12,4,172,23,413
20090619,74,15,25,3,7,2,117,16,259
20090620,64,11,17,3,6,1,87,9,198
20090621,16,6,6,0,1,0,17,7,53
20090622,95,12,23,1,7,2,118,11,269
20090623,75,12,29,1,11,1,113,11,253
20090624,85,9,23,4,4,1,91,13,230
20090625,96,13,33,2,6,1,136,14,301
20090626,60,13,25,3,11,0,100,10,222
20090627,78,14,30,3,8,0,85,7,225
20090628,22,1,5,0,3,1,31,3,66
20090629,78,13,30,2,9,1,108,15,256
20090630,91,6,37,5,11,2,128,19,299
20090701,92,15,33,2,11,2,127,19,301
20090702,90,9,30,6,11,1,131,16,294
20090703,61,6,18,3,10,1,87,13,199
20090704,48,6,17,2,0,0,71,7,151
20090705,20,3,10,2,4,0,23,2,64
20090706,76,5,29,5,9,1,84,13,222
20090707,86,10,41,4,10,0,107,12,270
20090708,77,11,35,1,10,0,121,6,261
20090709,98,12,24,1,7,0,112,20,274
20090710,104,11,27,1,11,0,112,16,282
20090711,72,7,18,3,10,2,88,12,212
20090712,37,3,9,0,4,0,47,13,113
20090713,80,8,38,5,13,1,119,20,284
20090714,94,10,26,3,9,0,119,19,280
20090715,84,16,24,1,9,0,145,22,301
20090716,86,11,34,3,11,2,156,12,315
20090717,88,8,29,1,8,1,124,20,279
20090718,54,3,16,4,8,1,88,10,184
20090719,23,2,7,2,3,0,26,4,67
20090720,49,9,30,4,10,1,105,12,220
20090721,72,8,17,3,5,0,90,9,204
20090722,67,14,21,2,5,0,88,12,209
20090723,61,7,22,4,6,1,92,12,205
20090724,53,12,20,2,5,1,72,6,171
20090725,48,4,23,2,7,0,69,11,164
20090726,19,1,7,1,1,0,24,6,59
20090727,73,4,18,0,4,1,91,12,203
20090728,61,2,20,4,10,2,80,12,191
20090729,81,10,20,1,6,0,110,9,237
20090730,91,5,26,3,8,2,119,18,272
20090731,95,12,26,5,11,2,162,17,330
20090801,59,8,15,0,3,1,61,14,161
20090802,22,4,8,0,6,0,47,3,90
20090803,93,15,32,4,7,1,133,25,310
20090804,72,5,29,5,4,1,123,12,251
20090805,83,11,35,1,11,2,148,22,313
20090806,104,14,26,0,15,1,161,22,343
20090807,76,5,26,0,8,2,103,20,240
20090808,75,6,21,0,4,0,101,15,222
20090809,24,0,6,0,3,0,40,2,75
20090810,82,7,32,1,9,0,110,11,252
20090811,90,12,37,9,8,0,124,20,300
20090812,99,10,30,6,13,1,103,14,276
20090813,101,12,42,2,18,2,174,26,377
20090814,93,9,32,6,8,1,166,14,329
20090815,77,7,19,2,6,1,112,19,243
20090816,20,4,11,2,0,0,29,9,75
20090817,84,10,30,4,16,0,121,25,290
20090818,76,14,34,2,12,0,147,22,307
20090819,92,6,39,3,15,0,114,24,293
20090820,74,9,46,3,13,0,124,20,289
20090821,90,7,29,1,7,2,125,15,276
20090822,53,7,21,2,6,1,75,17,182
20090823,26,1,4,1,2,0,33,5,72
20090824,85,5,22,4,9,0,86,15,226
20090825,102,13,29,3,15,2,157,32,353
20090826,76,6,26,5,8,0,97,16,234
20090827,92,7,32,3,14,1,132,17,298
20090828,66,9,19,1,3,1,110,17,226
20090829,75,4,14,3,10,2,80,7,195
20090830,17,3,5,0,2,0,28,4,59
20090831,68,7,25,2,10,0,97,21,230
20090901,79,10,19,2,10,1,108,22,251
20090902,80,10,27,4,8,1,122,17,269
20090903,64,13,20,2,9,0,116,10,234
20090904,86,9,34,0,10,0,88,17,244
20090905,65,5,17,0,5,0,82,18,192
20090906,15,2,13,0,2,1,34,4,71
20090907,37,3,10,0,7,0,38,3,98
20090908,74,12,33,3,9,1,117,19,268
20090909,97,11,33,5,8,2,124,13,293
20090910,88,7,39,2,10,1,128,19,294
20090911,60,4,22,5,4,1,113,13,222
20090912,91,11,38,2,7,0,101,11,261
20090913,28,3,15,0,6,0,36,4,92
20090914,80,5,29,2,8,3,105,20,252
20090915,65,6,27,6,6,0,106,13,229
20090916,90,8,32,4,13,1,110,10,268
20090917,75,8,34,2,8,0,115,13,255
20090918,68,10,28,4,3,1,111,10,235
20090919,85,6,29,3,9,0,101,10,243
20090920,24,4,5,1,3,1,28,7,73
20090921,68,13,29,5,7,1,93,10,226
20090922,74,4,26,5,7,0,95,18,229
20090923,81,11,29,1,8,1,112,16,259
20090924,87,12,29,1,7,2,123,15,276
20090925,71,14,26,1,13,0,110,16,251
20090926,66,5,30,2,12,2,104,16,237
20090927,41,5,10,4,4,1,44,7,116
20090928,60,9,38,0,8,0,96,12,223
20090929,91,7,30,2,5,2,118,15,270
20090930,91,11,24,1,17,1,147,17,309
20091001,77,4,27,2,4,2,98,11,225
20091002,64,2,23,3,7,2,93,20,214
20091003,49,6,23,1,7,0,78,8,172
20091004,26,1,9,1,7,1,37,5,87
20091005,51,5,22,3,11,1,118,12,223
20091006,84,11,41,6,10,0,140,24,316
20091007,87,12,22,6,9,1,140,10,287
20091008,98,9,28,5,15,0,138,16,309
20091009,53,5,14,2,11,0,82,12,179
20091010,53,10,15,1,8,0,59,11,157
20091011,23,1,10,0,2,0,33,6,75
20091012,18,6,9,1,0,0,26,6,66
20091013,64,6,27,5,4,1,112,13,232
20091014,85,11,38,3,8,2,107,29,283
20091015,91,13,28,5,11,2,136,22,308
20091016,60,3,29,2,6,2,93,17,212
20091017,66,6,20,1,9,0,57,8,167
20091018,22,1,6,1,3,0,38,2,73
20091019,71,14,32,4,4,1,84,13,223
20091020,80,8,24,8,9,1,110,15,255
20091021,81,12,26,2,11,0,108,25,265
20091022,109,7,39,4,11,0,138,15,323
20091023,119,10,33,2,7,1,134,14,320
20091024,78,11,32,4,8,1,121,13,268
20091025,18,1,6,0,2,0,39,8,74
20091026,57,6,24,3,7,2,87,11,197
20091027,84,16,25,4,6,1,156,15,307
20091028,75,11,24,5,6,1,140,17,279
20091029,67,7,21,1,5,1,101,11,214
20091030,85,15,32,4,6,4,99,13,258
20091031,49,5,8,0,6,0,56,8,132
20091101,19,3,8,0,3,1,26,5,65
20091102,33,3,6,0,5,0,49,7,103
20091103,74,6,29,3,15,1,107,15,250
20091104,85,10,25,3,4,0,120,12,259
20091105,75,5,20,3,7,1,94,12,217
20091106,83,8,18,4,7,1,147,18,286
20091107,33,6,14,2,9,0,49,8,121
20091108,18,1,7,1,4,0,32,5,68
20091109,76,5,21,3,10,0,94,16,225
20091110,72,9,25,3,4,1,81,11,206
20091111,57,4,20,2,7,1,97,12,200
20091112,65,5,27,2,4,0,99,17,219
20091113,68,10,25,2,5,1,90,11,212
20091114,55,3,18,2,4,2,57,7,148
20091115,15,2,9,0,6,0,37,1,70
20091116,53,3,20,0,8,1,87,13,185
20091117,84,11,17,5,6,0,96,14,233
20091118,77,6,28,2,6,3,122,24,268
20091119,74,5,27,5,2,0,106,17,236
20091120,18,3,11,0,9,0,44,11,96
20091121,48,5,12,2,8,0,61,11,147
20091122,21,1,5,0,1,0,29,3,60
20091123,59,7,27,1,5,2,97,22,220
20091124,73,11,27,2,6,0,118,23,260
20091125,145,13,55,5,23,1,218,30,490
20091126,92,14,30,4,10,1,162,14,327
20091127,93,10,31,3,8,3,179,11,338
20091128,97,14,43,3,17,3,159,22,358
20091129,26,3,12,1,2,0,44,8,96
20091130,93,6,23,4,8,2,122,21,279
20091201,71,9,30,4,11,2,121,23,271
20091202,100,16,26,1,10,1,137,27,318
20091203,89,7,22,5,6,0,122,23,274
20091204,61,7,18,3,6,3,83,13,194
20091205,48,6,11,1,5,2,79,7,159
20091206,29,4,11,1,6,0,39,5,95
20091207,63,13,36,3,3,0,129,24,271
20091208,61,10,25,1,9,0,103,15,224
20091209,45,5,17,0,4,1,87,12,171
20091210,57,8,27,2,14,0,87,13,208
20091211,69,9,24,0,4,2,84,20,212
20091212,57,9,29,0,5,0,101,14,215
20091213,28,3,7,1,7,1,37,4,88
20091214,48,6,28,1,8,0,107,14,212
20091215,79,10,37,3,4,0,124,21,278
20091216,92,5,22,1,6,0,101,17,244
20091217,59,11,24,2,4,0,104,12,216
20091218,76,10,23,2,10,3,96,14,234
20091219,44,5,15,1,8,0,61,4,138
20091220,26,6,7,2,2,0,30,4,77
20091221,57,8,23,1,7,0,100,11,207
20091222,58,8,20,2,8,0,104,24,224
20091223,45,5,18,2,8,1,78,13,170
20091224,29,4,12,1,2,1,49,5,103
20091225,7,2,5,0,2,0,12,0,28
20091226,44,3,14,2,9,0,73,8,153
20091227,30,2,8,1,1,0,28,1,71
20091228,69,12,29,2,7,2,109,10,240
20091229,140,9,38,5,16,1,215,34,458
20091230,129,17,43,8,17,3,182,23,422
20091231,60,9,34,3,13,0,112,11,242
20100101,0,0,0,0,0,0,0,0,0
20100102,69,8,21,5,6,0,100,12,221
20100103,23,2,6,2,2,0,41,4,80
20100104,81,7,20,8,11,2,131,18,278
20100105,86,7,31,4,10,2,134,25,299
20100106,107,11,32,2,11,1,149,17,330
20100107,93,6,38,3,15,1,103,19,278
20100108,99,13,32,5,20,5,140,11,325
20100109,60,6,27,2,8,1,93,14,211
20100110,19,0,6,1,2,0,25,7,60
20100111,94,8,42,2,13,1,127,23,310
20100112,104,10,25,6,9,1,130,20,305
20100113,79,6,23,4,10,1,101,19,243
20100114,71,5,24,7,9,2,103,17,238
20100115,86,7,34,4,9,0,120,9,269
20100116,66,11,19,3,6,0,73,16,194
20100117,16,2,5,0,1,1,22,6,53
20100118,77,10,26,2,11,1,132,18,277
20100119,76,11,34,1,6,0,136,19,283
20100120,42,5,7,2,3,1,65,6,131
20100121,56,8,34,3,12,0,99,8,220
20100122,77,10,39,2,8,2,100,18,256
20100123,57,4,9,6,11,1,90,7,185
20100124,27,4,9,1,1,0,35,6,83
20100125,94,7,27,3,3,0,113,21,268
20100126,78,6,21,3,11,0,109,18,246
20100127,92,9,26,3,10,0,134,13,287
20100128,89,7,35,2,11,0,126,16,286
20100129,84,11,31,3,8,0,148,17,302
20100130,53,9,18,3,3,1,80,7,174
20100131,15,3,5,0,1,0,21,2,47
20100201,81,11,25,2,9,1,122,18,269
20100202,81,12,25,3,5,3,142,21,292
20100203,110,10,35,1,6,3,116,21,302
20100204,53,5,17,3,3,2,73,9,165
20100205,68,5,29,3,5,0,83,13,206
20100206,92,12,25,3,8,1,126,20,287
20100207,20,0,9,1,1,0,24,3,58
20100208,84,11,33,4,5,1,116,19,273
20100209,78,7,30,6,13,1,121,24,280
20100210,87,13,28,1,12,1,126,13,281
20100211,86,12,40,5,4,0,141,15,303
20100212,102,12,36,2,12,2,153,21,340
20100213,42,6,20,1,6,0,60,8,143
20100214,15,7,3,0,0,0,23,4,52
20100215,37,3,17,1,3,1,53,8,123
20100216,17,2,4,0,1,0,39,7,70
20100217,40,3,14,2,10,2,61,6,138
20100218,55,9,21,0,6,1,87,11,190
20100219,61,5,19,1,11,0,87,12,196
20100220,58,5,21,4,3,0,66,16,173
20100221,14,1,3,0,1,0,15,6,40
20100222,97,6,24,3,14,0,119,14,277
20100223,102,7,50,2,9,1,132,27,330
20100224,73,9,17,6,11,0,106,17,239
20100225,48,4,18,6,10,0,95,11,192
20100226,63,6,39,0,5,0,117,10,240
20100227,65,10,24,1,8,0,86,13,207
20100228,28,5,16,0,4,0,43,3,99
20100301,66,5,17,2,7,1,103,9,210
20100302,69,11,28,6,5,2,118,17,256
20100303,130,20,32,4,18,4,208,24,440
20100304,114,14,59,5,12,1,161,20,386
20100305,72,7,27,2,11,1,100,7,227
20100306,71,6,21,1,5,4,82,8,198
20100307,20,3,8,2,3,2,35,4,77
20100308,86,7,39,3,10,1,134,15,295
20100309,88,10,35,6,10,1,125,21,296
20100310,88,11,39,5,6,0,119,12,280
20100311,84,8,30,3,13,3,136,12,289
20100312,91,11,28,3,19,1,130,18,301
20100313,52,6,21,2,8,0,78,8,175
20100314,42,3,18,2,2,0,49,8,124
20100315,90,11,36,6,8,3,142,18,314
20100316,102,11,44,3,7,2,150,19,338
20100317,91,14,32,2,12,1,131,21,304
20100318,129,19,51,5,16,3,135,18,376
20100319,67,8,23,1,7,4,117,12,239
20100320,76,6,24,3,4,0,91,15,219
20100321,31,3,7,3,6,0,34,7,91
20100322,80,12,29,5,8,1,132,15,282
20100323,75,11,35,2,5,2,106,15,251
20100324,71,7,28,1,6,2,106,17,238
20100325,97,10,36,3,7,2,159,12,326
20100326,62,6,28,1,8,1,116,15,237
20100327,64,9,28,1,8,2,91,17,220
20100328,19,1,5,1,1,0,24,2,53
20100329,89,8,27,1,6,1,105,10,247
20100330,73,13,30,3,12,0,111,12,254
20100331,93,7,42,5,11,3,143,14,318
20100401,51,8,17,4,11,0,109,20,220
20100402,27,0,4,0,1,0,34,3,69
20100403,74,9,16,0,4,1,79,10,193
20100404,16,2,3,0,4,0,18,6,49
20100405,57,11,26,3,8,0,88,18,211
20100406,16,3,4,1,3,0,30,4,61
20100407,60,6,21,1,5,0,76,7,176
20100408,98,18,34,6,8,0,161,24,349
20100409,158,13,43,5,19,3,204,16,461
20100410,83,15,28,2,2,2,113,13,258
20100411,67,10,25,5,10,2,111,9,239
20100412,98,10,28,3,14,0,148,22,323
20100413,124,18,52,6,7,0,166,28,401
20100414,123,13,52,5,17,2,153,28,393
20100415,95,13,33,4,11,0,141,21,318
20100416,91,6,28,1,10,2,124,24,286
20100417,83,8,33,1,13,3,115,22,278
20100418,31,1,8,1,2,0,32,4,79
20100419,74,10,37,2,7,1,111,22,264
20100420,77,14,24,2,13,1,105,14,250
20100421,44,5,19,1,3,1,61,11,145
20100422,74,8,30,4,9,0,121,16,262
20100423,40,5,25,0,4,0,67,4,145
20100424,59,12,32,2,7,1,98,15,226
20100425,33,3,8,2,2,1,53,4,106
20100426,70,10,35,3,9,2,97,13,239
20100427,84,7,32,7,8,1,145,10,294
20100428,95,12,31,2,8,3,121,23,295
20100429,61,7,19,3,7,0,100,9,206
20100430,88,7,28,4,6,0,111,14,258
20100501,47,3,8,2,6,2,64,9,141
20100502,21,1,12,0,1,1,44,5,85
20100503,90,4,24,2,11,0,90,22,243
20100504,105,17,40,5,3,0,146,12,328
20100505,115,14,35,5,10,1,125,25,330
20100506,93,10,23,5,8,1,92,20,252
20100507,87,9,23,2,10,1,114,22,268
20100508,68,7,19,2,6,0,75,12,189
20100509,28,4,7,0,4,0,30,0,73
20100510,73,9,29,3,6,1,93,18,232
20100511,64,7,22,1,9,0,106,9,218
20100512,76,11,28,1,8,0,117,15,256
20100513,95,12,31,3,14,3,152,25,335
20100514,81,8,21,2,5,2,90,13,222
20100515,71,5,17,2,8,0,96,16,215
20100516,20,2,7,1,1,0,39,4,74
20100517,69,6,28,1,14,2,103,19,242
20100518,79,11,39,7,8,1,117,20,282
20100519,102,11,32,4,11,1,140,15,316
20100520,77,5,31,6,9,2,114,21,265
20100521,67,9,29,4,8,0,83,13,213
20100522,63,5,31,3,3,0,57,16,178
20100523,16,5,5,2,2,0,18,2,50
20100524,70,6,27,1,8,1,88,18,219
20100525,93,5,37,6,9,1,147,20,318
20100526,84,11,26,3,11,2,117,23,277
20100527,81,7,27,4,4,1,106,15,245
20100528,69,4,23,2,5,1,93,5,202
20100529,56,6,25,4,3,0,85,10,189
20100530,14,2,4,0,1,0,23,6,50
20100531,51,5,30,3,9,0,94,10,202
20100601,38,4,26,2,5,0,64,11,150
20100602,40,6,21,2,8,1,69,12,159
20100603,19,2,6,0,4,0,45,9,85
20100604,77,8,24,4,12,0,100,17,242
20100605,52,6,13,0,9,0,77,15,172
20100606,31,1,9,0,1,0,29,4,75
20100607,101,9,28,2,9,2,134,16,301
20100608,74,8,32,5,11,0,106,17,253
20100609,78,6,31,2,12,1,104,18,252
20100610,94,8,27,3,15,0,147,15,309
20100611,109,12,34,6,16,2,156,15,350
20100612,43,6,18,2,9,0,61,10,149
20100613,30,0,10,0,4,0,39,5,88
20100614,87,11,21,2,10,0,107,18,256
20100615,39,10,23,7,5,2,63,13,162
20100616,78,2,32,2,6,1,108,5,234
20100617,97,5,28,4,9,0,134,25,302
20100618,69,9,27,4,11,0,126,19,265
20100619,60,7,25,0,5,1,106,15,219
20100620,31,2,7,0,2,0,34,6,82
20100621,72,6,26,3,7,1,123,16,254
20100622,81,11,33,2,13,1,125,15,281
20100623,62,11,26,1,11,0,106,10,227
20100624,91,15,27,3,9,1,157,18,321
20100625,48,4,19,1,5,1,62,10,150
20100626,73,10,24,3,10,2,86,13,221
20100627,44,4,16,1,6,0,34,10,115
20100628,54,9,19,2,9,2,71,11,177
20100629,90,7,34,8,3,0,108,11,261
20100630,78,15,35,2,10,4,108,27,279
20100701,94,14,32,7,7,0,155,16,325
20100702,51,7,9,1,8,1,72,6,155
20100703,46,5,13,3,8,2,78,10,165
20100704,13,1,10,1,1,0,21,5,52
20100705,62,4,26,4,10,0,113,8,227
20100706,79,14,34,4,11,3,114,8,267
20100707,70,10,22,7,6,0,108,9,232
20100708,107,8,32,1,10,1,122,11,292
20100709,69,14,23,2,8,2,107,11,236
20100710,77,6,25,4,8,2,79,15,216
20100711,11,0,6,0,1,0,15,3,36
20100712,63,4,29,3,6,1,109,10,225
20100713,69,5,19,2,11,0,119,18,243
20100714,69,12,20,1,10,0,100,22,234
20100715,35,5,19,3,3,0,87,17,169
20100716,70,6,16,3,6,2,94,13,210
20100717,63,5,17,4,10,1,80,13,193
20100718,22,1,12,1,0,0,26,4,66
20100719,56,11,29,4,10,0,111,22,243
20100720,70,12,26,4,7,2,108,16,245
20100721,53,4,20,0,11,0,93,10,191
20100722,96,8,32,6,16,1,148,13,320
20100723,76,12,32,2,10,0,88,21,241
20100724,76,12,31,1,11,3,94,18,246
20100725,33,2,13,2,3,0,42,9,104
20100726,67,7,17,2,3,2,89,23,210
20100727,118,11,30,2,17,1,147,30,356
20100728,75,7,26,1,7,0,97,10,223
20100729,67,4,28,1,13,1,106,14,234
20100730,71,6,31,1,4,1,132,15,261
20100731,79,12,25,2,11,1,80,12,222
20100801,18,2,13,0,4,0,24,3,64
20100802,64,7,23,4,7,1,92,14,212
20100803,86,9,20,2,6,1,99,10,233
20100804,66,11,23,0,10,0,93,14,217
20100805,79,9,30,3,12,1,104,17,255
20100806,90,5,33,2,18,0,126,14,288
20100807,84,13,30,1,10,1,110,20,269
20100808,18,2,11,0,0,0,15,4,50
20100809,79,7,22,1,9,0,108,18,244
20100810,91,11,28,3,8,1,126,22,290
20100811,85,10,22,3,5,2,116,10,253
20100812,73,8,31,1,5,2,110,12,242
20100813,59,12,33,6,8,0,117,19,254
20100814,73,11,17,0,9,1,89,15,215
20100815,28,4,4,1,2,0,30,4,73
20100816,56,8,14,1,6,1,83,8,177
20100817,86,10,32,1,12,0,110,16,267
20100818,78,16,23,3,10,1,105,13,249
20100819,63,11,34,4,4,0,103,17,236
20100820,68,4,19,1,7,1,116,10,226
20100821,37,3,19,2,6,2,75,11,155
20100822,34,4,6,1,1,1,21,5,73
20100823,59,8,25,0,8,3,111,12,226
20100824,90,14,34,3,5,0,100,17,263
20100825,83,11,26,5,6,0,118,21,270
20100826,79,7,24,0,15,1,127,16,269
20100827,59,10,27,6,9,0,110,9,230
20100828,60,9,20,2,5,0,75,18,189
20100829,22,3,3,0,1,0,23,1,53
20100830,64,3,13,5,10,0,76,12,183
20100831,90,11,32,5,11,1,115,21,286
20100901,87,12,25,5,7,0,146,24,306
20100902,73,7,37,3,9,0,115,10,254
20100903,57,4,25,4,10,0,78,12,190
20100904,53,5,23,0,4,2,61,12,160
20100905,18,2,6,1,0,0,20,2,49
20100906,75,8,31,4,6,2,80,15,221
20100907,28,2,9,2,3,0,39,7,90
20100908,57,6,25,3,8,0,64,13,176
20100909,66,8,25,1,11,1,112,13,237
20100910,99,8,28,3,11,1,125,12,287
20100911,40,1,16,3,3,0,56,10,129
20100912,15,2,8,1,0,0,31,4,61
20100913,60,7,19,4,3,1,97,6,197
20100914,79,7,30,2,6,1,125,19,269
20100915,88,6,32,3,8,1,109,18,265
20100916,73,12,29,5,10,2,109,14,254
20100917,84,6,16,3,7,2,127,19,264
20100918,52,11,20,1,4,0,63,16,167
20100919,30,2,7,1,1,0,37,4,82
20100920,58,7,24,1,5,1,91,13,200
20100921,75,11,30,6,11,2,115,20,270
20100922,77,12,39,7,8,1,130,19,293
20100923,83,5,25,2,11,0,96,8,230
20100924,74,4,26,3,13,0,93,16,229
20100925,62,5,21,3,6,0,93,15,205
20100926,23,3,7,1,3,0,24,1,62
20100927,69,3,23,1,14,0,75,7,192
20100928,93,8,20,6,9,2,141,14,293
20100929,78,9,37,4,6,1,133,18,286
20100930,87,11,43,5,10,1,136,20,313
20101001,82,10,27,0,6,0,91,11,227
20101002,35,4,16,2,4,0,53,9,123
20101003,14,3,2,1,3,0,24,5,52
20101004,78,13,19,2,4,0,99,21,236
20101005,105,20,32,4,10,1,113,14,299
20101006,86,6,28,1,11,0,120,16,268
20101007,100,16,43,2,12,1,164,23,361
20101008,87,7,31,3,9,1,119,15,272
20101009,46,5,15,2,8,0,64,14,154
20101010,22,1,8,0,7,1,38,6,83
20101011,76,10,39,2,11,0,147,16,301
20101012,42,3,9,3,4,1,58,5,125
20101013,52,6,21,2,8,2,91,6,188
20101014,107,10,26,6,8,3,116,18,294
20101015,118,11,35,3,15,1,138,19,340
20101016,46,6,24,0,3,0,83,14,176
20101017,35,3,7,0,3,0,28,7,83
20101018,66,11,31,4,13,2,133,13,273
20101019,93,12,42,5,9,3,118,25,307
20101020,132,12,36,5,10,1,161,18,375
20101021,84,8,31,7,15,1,118,15,279
20101022,84,13,28,3,9,2,115,15,269
20101023,80,10,24,5,9,1,116,7,252
20101024,13,1,5,1,0,0,20,3,43
20101025,67,7,25,1,9,1,87,16,213
20101026,79,7,34,4,15,0,113,17,269
20101027,78,9,29,4,6,0,89,14,229
20101028,70,10,22,2,6,1,100,8,219
20101029,72,10,31,0,10,0,109,11,243
20101030,59,9,20,2,5,0,100,14,209
20101031,11,2,6,0,0,0,21,4,44
20101101,64,6,32,2,11,2,117,13,247
20101102,21,11,9,0,5,1,32,8,87
20101103,71,5,31,3,12,0,82,6,210
20101104,134,22,35,4,15,2,148,32,392
20101105,71,5,32,4,8,1,109,12,242
20101106,51,6,19,3,8,1,70,11,169
20101107,35,3,11,1,4,0,38,4,96
20101108,72,12,24,2,8,0,104,17,239
20101109,72,4,32,3,10,1,112,15,249
20101110,100,13,34,6,9,0,125,21,308
20101111,68,10,26,1,5,0,113,16,239
20101112,72,8,29,3,6,1,108,12,239
20101113,41,3,18,4,2,1,64,8,141
20101114,21,0,4,1,0,0,14,6,46
20101115,27,6,10,0,3,0,41,7,94
20101116,62,7,25,3,6,1,64,13,181
20101117,109,10,37,1,7,1,124,12,301
20101118,65,14,28,1,8,2,108,12,238
20101119,52,3,21,0,12,2,88,14,192
20101120,33,10,12,3,5,1,79,6,149
20101121,28,2,13,1,3,0,32,4,83
20101122,73,4,22,2,5,0,102,11,219
20101123,72,7,33,7,6,0,96,16,237
20101124,65,5,36,5,9,2,123,15,260
20101125,129,11,39,8,18,0,146,22,373
20101126,114,17,31,3,10,0,191,15,381
20101127,97,15,30,2,8,0,126,13,291
20101128,28,2,7,1,2,0,43,5,88
20101129,92,7,22,5,11,0,112,12,261
20101130,97,10,37,5,7,3,118,11,288
20101201,81,10,36,2,16,0,145,21,311
20101202,117,14,42,2,10,1,123,19,328
20101203,80,18,18,5,9,0,113,20,263
20101204,55,6,21,4,2,0,78,17,183
20101205,19,1,10,2,3,0,32,4,71
20101206,56,7,32,2,4,0,89,17,207
20101207,64,4,24,1,6,0,94,12,205
20101208,81,11,25,0,5,1,94,18,235
20101209,62,6,19,4,1,1,84,15,192
20101210,56,11,22,4,11,0,94,12,210
20101211,55,1,26,2,7,1,95,11,198
20101212,22,3,9,0,1,1,30,4,70
20101213,61,5,27,1,8,1,81,11,195
20101214,53,10,23,3,5,2,76,4,176
20101215,62,5,17,6,1,0,102,14,207
20101216,48,7,23,0,5,0,92,13,188
20101217,56,7,19,2,8,1,87,6,186
20101218,58,3,19,2,2,0,60,9,153
20101219,22,2,8,0,1,0,28,7,68
20101220,45,8,27,4,10,2,81,14,191
20101221,65,5,19,1,3,1,92,18,204
20101222,83,4,32,3,8,1,84,9,224
20101223,88,13,21,3,10,1,127,14,277
20101224,63,8,35,3,8,1,108,15,241
20101225,23,3,2,1,8,0,35,6,78
20101226,34,2,11,1,2,0,20,4,74
20101227,93,10,33,5,9,0,126,19,295
20101228,94,10,30,3,9,1,161,18,326
20101229,147,19,43,3,13,2,186,23,436
20101230,132,13,57,6,13,0,187,21,429
20101231,115,5,30,6,11,1,127,19,314
20110101,0,0,0,0,0,0,0,0,0
20110102,24,8,6,1,1,0,39,9,88
20110103,68,8,42,5,7,2,131,20,283
20110104,85,6,34,8,11,1,125,20,290
20110105,99,4,44,1,13,2,129,28,320
20110106,78,9,34,5,11,1,111,16,265
20110107,93,6,34,4,12,1,148,16,314
20110108,65,3,14,0,11,0,96,14,203
20110109,18,4,7,0,4,0,35,4,72
20110110,79,5,26,2,6,2,125,23,268
20110111,81,9,24,3,2,2,124,19,264
20110112,91,10,49,1,13,1,141,23,329
20110113,236,31,70,6,24,1,321,56,745
20110114,238,33,74,9,32,2,349,43,780
20110115,240,33,74,11,24,4,334,65,785
20110116,218,19,65,6,20,4,256,32,620
20110117,187,31,79,6,19,4,283,49,658
20110118,195,20,63,6,11,1,279,27,602
20110119,135,30,54,2,18,4,216,30,489
20110120,103,10,30,7,12,1,148,20,331
20110121,161,12,56,6,18,1,240,33,527
20110122,119,10,38,7,18,1,152,18,363
20110123,51,4,15,1,11,0,76,6,164
20110124,104,10,39,2,17,1,180,16,369
20110125,99,19,41,7,16,1,199,17,399
20110126,109,14,41,3,11,3,151,21,353
20110127,111,10,35,4,12,1,136,14,323
20110128,92,11,40,6,12,0,175,18,354
20110129,75,5,26,6,9,0,109,12,242
20110130,28,3,11,0,3,0,23,4,72
20110131,89,11,36,4,15,1,148,27,331
20110201,86,7,36,2,11,2,150,18,312
20110202,94,7,25,3,12,1,142,19,303
20110203,93,9,39,4,15,1,151,16,328
20110204,79,9,35,5,11,0,108,12,259
20110205,72,4,22,3,12,0,104,18,235
20110206,11,2,9,3,1,0,28,2,56
20110207,92,5,32,7,16,0,116,26,294
20110208,80,3,25,8,11,5,109,19,260
20110209,104,16,27,4,15,4,122,23,315
20110210,78,3,38,0,15,1,91,13,239
20110211,69,7,22,2,6,1,114,11,232
20110212,39,6,22,2,5,1,70,7,152
20110213,14,3,9,1,1,0,37,5,70
20110214,73,8,14,0,11,0,110,16,232
20110215,68,11,29,10,7,0,109,17,251
20110216,53,6,29,2,8,2,108,10,218
20110217,93,13,35,4,6,0,132,15,298
20110218,60,5,17,3,8,0,91,10,194
20110219,69,12,21,0,7,2,78,13,202
20110220,25,5,13,0,1,0,31,4,79
20110221,74,4,30,5,5,1,105,12,236
20110222,97,9,32,3,10,0,127,16,294
20110223,94,8,41,2,14,4,129,13,305
20110224,77,9,37,3,11,2,107,9,255
20110225,54,6,28,2,10,1,94,9,204
20110226,74,8,24,2,4,1,97,17,227
20110227,29,2,6,0,1,1,33,4,76
20110228,72,6,24,1,5,2,111,13,234
20110301,128,7,33,4,15,3,180,17,387
20110302,94,12,34,3,10,2,118,19,292
20110303,65,10,25,4,12,0,105,10,231
20110304,88,10,23,5,9,1,103,13,252
20110305,31,3,20,0,5,0,52,4,115
20110306,15,1,7,0,3,0,33,5,64
20110307,38,4,16,1,4,0,62,6,131
20110308,23,3,5,1,1,0,20,4,57
20110309,40,1,21,2,2,0,57,6,129
20110310,50,4,22,4,2,1,61,11,155
20110311,63,8,25,6,17,0,90,11,220
20110312,37,7,12,3,7,1,57,8,132
20110313,23,2,4,0,1,0,34,6,70
20110314,70,3,20,0,11,0,101,9,214
20110315,69,6,26,1,9,2,108,12,233
20110316,71,8,22,3,2,1,108,14,229
20110317,59,4,21,1,11,0,90,16,202
20110318,74,10,34,2,11,0,139,24,294
20110319,37,10,19,1,5,0,66,7,145
20110320,32,2,14,2,4,1,34,3,92
20110321,95,4,26,1,6,0,119,10,261
20110322,76,10,29,4,8,0,97,19,243
20110323,95,12,36,5,6,2,140,25,321
20110324,96,10,34,3,7,1,128,16,295
20110325,92,8,30,2,7,2,147,15,303
20110326,62,9,34,2,6,2,92,10,217
20110327,27,5,5,0,2,0,42,6,87
20110328,73,13,32,2,9,1,95,19,244
20110329,114,15,24,2,9,2,119,21,306
20110330,77,11,38,5,9,2,109,18,269
20110331,93,14,39,5,6,0,125,19,301
20110401,107,13,32,4,14,1,109,18,298
20110402,47,10,21,0,6,0,62,10,156
20110403,26,4,10,0,2,0,18,2,62
20110404,77,7,29,6,10,0,112,18,259
20110405,99,8,33,4,3,2,112,12,273
20110406,84,13,35,3,6,2,130,13,286
20110407,181,22,57,3,15,1,240,38,557
20110408,170,16,63,5,28,0,236,35,553
20110409,105,13,43,10,9,0,174,29,383
20110410,67,8,17,1,1,0,69,12,175
20110411,109,10,47,3,9,1,143,20,342
20110412,93,9,28,3,10,0,135,19,297
20110413,99,12,34,6,10,2,140,16,319
20110414,91,8,33,2,8,1,139,23,305
20110415,49,11,28,2,6,1,108,19,224
20110416,91,7,22,2,7,4,91,18,242
20110417,40,3,9,2,1,0,33,8,96
20110418,79,3,21,1,9,0,92,15,220
20110419,78,8,23,1,4,1,118,8,241
20110420,75,16,35,1,17,2,127,22,295
20110421,29,0,9,1,2,0,40,9,90
20110422,24,6,24,4,2,0,43,10,113
20110423,48,6,21,1,6,0,61,9,152
20110424,19,0,12,2,3,1,30,6,73
20110425,64,2,20,1,7,0,70,9,173
20110426,74,9,41,6,6,1,110,13,260
20110427,65,6,29,2,9,2,117,17,247
20110428,71,11,33,0,9,1,91,12,228
20110429,59,7,33,1,5,0,89,16,210
20110430,64,3,26,1,11,0,87,13,205
20110501,19,3,12,1,2,0,23,3,63
20110502,55,6,32,0,11,3,76,15,198
20110503,61,5,12,1,5,1,80,7,172
20110504,67,11,25,3,8,0,129,15,258
20110505,80,13,31,2,8,2,107,21,264
20110506,56,5,18,0,4,0,92,24,199
20110507,64,7,16,2,5,0,84,14,192
20110508,15,0,5,1,4,0,29,6,60
20110509,80,6,27,3,7,2,119,19,263
20110510,55,11,21,5,8,0,89,9,198
20110511,64,7,25,3,9,1,104,20,233
20110512,93,7,24,3,11,1,127,24,290
20110513,55,6,22,3,6,1,102,19,214
20110514,47,6,17,3,8,0,68,13,162
20110515,19,5,8,2,5,0,32,8,79
20110516,67,9,26,1,9,0,96,19,227
20110517,77,9,16,3,9,1,75,12,202
20110518,50,7,22,0,8,2,97,17,203
20110519,52,6,27,0,10,0,89,15,199
20110520,84,8,24,1,13,0,94,16,240
20110521,43,4,14,4,6,0,59,14,144
20110522,27,3,11,0,3,0,33,5,82
20110523,48,6,28,1,4,2,91,17,197
20110524,82,8,33,9,13,0,131,25,301
20110525,68,6,26,3,3,0,80,12,198
20110526,54,7,22,1,10,2,86,12,194
20110527,69,4,28,3,1,2,104,10,221
20110528,77,14,38,3,9,2,90,25,258
20110529,35,5,16,3,5,0,56,5,125
20110530,75,4,22,2,7,1,100,19,230
20110531,73,9,25,5,11,1,117,19,260
20110601,64,7,23,2,6,0,86,10,198
20110602,95,10,29,3,19,1,115,22,294
20110603,63,10,20,1,4,3,95,12,208
20110604,65,7,25,1,11,1,74,13,197
20110605,18,0,4,0,4,0,30,7,63
20110606,50,6,18,2,9,0,101,11,197
20110607,79,9,25,2,10,1,67,13,206
20110608,66,8,29,2,6,0,83,13,207
20110609,62,12,28,3,9,0,117,14,245
20110610,64,5,19,5,9,2,99,12,215
20110611,81,9,18,0,9,0,85,8,210
20110612,19,3,3,1,3,0,31,2,62
20110613,81,6,33,3,8,1,109,9,250
20110614,100,5,43,4,9,0,133,17,311
20110615,105,8,46,4,13,0,146,17,339
20110616,98,8,28,4,6,1,114,16,275
20110617,76,8,29,5,13,0,115,17,263
20110618,58,12,33,1,6,0,79,11,200
20110619,22,1,10,3,0,0,40,3,79
20110620,85,17,30,2,7,0,133,18,292
20110621,70,11,21,0,10,0,99,18,229
20110622,76,10,27,2,8,1,107,16,247
20110623,39,7,12,3,4,1,65,7,138
20110624,99,14,26,4,8,1,129,13,294
20110625,47,10,12,2,2,1,55,12,141
20110626,27,0,4,1,1,0,27,8,68
20110627,81,5,40,8,10,1,126,17,288
20110628,79,13,21,1,8,0,117,22,261
20110629,85,4,37,5,9,0,106,11,257
20110630,97,6,34,6,9,0,118,21,291
20110701,52,5,29,2,15,1,96,17,217
20110702,52,6,13,2,8,3,69,11,164
20110703,22,7,5,0,3,0,44,4,85
20110704,64,11,21,1,9,1,87,15,209
20110705,83,8,21,0,7,1,122,11,253
20110706,76,6,19,0,5,0,97,7,210
20110707,60,4,19,2,5,0,86,7,183
20110708,64,10,31,4,6,0,91,10,216
20110709,93,10,30,2,8,0,125,12,280
20110710,19,2,3,1,1,1,35,2,64
20110711,75,5,20,2,11,0,113,16,242
20110712,67,7,25,3,5,1,90,13,211
20110713,97,4,29,1,5,1,142,13,292
20110714,88,6,26,4,10,1,99,13,247
20110715,96,17,26,3,14,0,119,15,290
20110716,49,8,15,2,10,0,73,10,167
20110717,15,1,5,0,2,0,22,2,47
20110718,58,5,24,2,9,1,99,9,207
20110719,64,15,38,3,5,1,122,19,267
20110720,79,7,29,5,10,0,114,18,262
20110721,95,6,29,3,9,2,105,16,265
20110722,70,13,35,3,9,1,117,14,262
20110723,63,9,22,1,4,1,81,15,196
20110724,20,2,9,0,4,0,23,4,62
20110725,81,5,30,3,15,2,119,11,266
20110726,100,7,32,2,6,1,138,20,306
20110727,69,4,26,2,10,2,104,19,236
20110728,60,7,39,2,9,0,88,17,222
20110729,74,5,30,2,8,0,122,16,257
20110730,75,10,32,2,4,1,87,14,225
20110731,29,2,7,0,3,0,40,11,92
20110801,57,13,25,2,3,1,81,12,194
20110802,90,7,34,1,8,0,116,17,273
20110803,69,12,29,0,11,2,115,13,251
20110804,91,11,41,4,4,0,112,20,283
20110805,75,13,31,3,8,0,98,9,237
20110806,81,6,19,1,9,0,97,13,226
20110807,43,4,8,1,3,0,49,12,120
20110808,96,15,29,4,13,0,100,15,272
20110809,70,19,22,4,11,7,135,17,285
20110810,88,130,40,2,9,0,184,33,486
20110811,104,55,27,3,6,2,134,29,360
20110812,95,30,25,1,8,1,130,22,312
20110813,93,13,25,3,10,2,114,20,280
20110814,28,1,5,0,3,0,30,3,70
20110815,78,12,38,2,8,0,107,16,261
20110816,82,18,24,3,6,1,139,21,294
20110817,87,10,33,2,9,1,121,19,282
20110818,100,10,29,5,10,0,136,21,311
20110819,93,16,31,5,13,1,147,23,329
20110820,77,8,21,1,9,1,86,16,219
20110821,22,4,7,0,3,0,30,7,73
20110822,92,13,23,1,5,2,95,15,246
20110823,85,15,31,4,9,1,124,22,291
20110824,76,8,17,0,5,1,86,13,206
20110825,66,7,21,4,15,1,88,10,212
20110826,90,12,25,5,11,1,118,16,278
20110827,68,5,30,0,6,0,91,12,212
20110828,16,3,5,1,2,0,38,4,69
20110829,75,12,35,4,8,0,111,13,258
20110830,90,6,32,1,9,3,115,17,273
20110831,61,9,22,3,11,0,114,18,238
20110901,52,7,25,2,5,0,90,16,197
20110902,73,9,17,9,6,0,102,10,226
20110903,45,3,13,3,5,0,58,5,132
20110904,24,1,6,0,2,1,18,3,55
20110905,60,8,23,0,6,0,87,14,198
20110906,73,9,20,0,11,2,116,13,244
20110907,25,6,11,1,4,0,34,8,89
20110908,65,7,27,1,7,0,80,10,197
20110909,60,11,25,6,8,2,97,12,221
20110910,59,9,23,3,11,1,112,14,232
20110911,17,2,6,0,3,0,28,4,60
20110912,58,4,21,1,6,1,92,19,202
20110913,59,8,20,2,3,1,70,16,179
20110914,69,9,19,3,8,2,109,12,231
20110915,79,7,31,2,5,1,101,20,246
20110916,59,3,20,2,5,0,64,16,169
20110917,54,4,10,4,5,2,89,13,181
20110918,15,1,5,0,0,0,30,4,55
20110919,60,12,19,2,6,1,74,10,184
20110920,84,7,39,1,8,0,125,13,277
20110921,96,11,33,5,12,0,131,11,299
20110922,83,8,29,2,15,0,123,16,276
20110923,74,10,24,5,4,0,98,8,223
20110924,42,3,17,0,2,0,82,15,161
20110925,15,1,9,0,3,0,37,8,73
20110926,54,6,24,1,5,1,81,12,184
20110927,64,8,25,3,11,0,99,18,228
20110928,50,6,18,3,8,1,81,17,184
20110929,71,6,31,0,8,1,108,17,242
20110930,80,10,27,3,7,1,103,12,243
20111001,72,9,17,1,5,1,90,14,209
20111002,26,3,16,2,1,0,30,4,82
20111003,58,6,24,2,7,0,92,9,198
20111004,74,8,27,6,4,1,83,15,218
20111005,74,5,31,6,9,2,105,19,251
20111006,49,6,28,1,9,1,76,15,185
20111007,68,7,22,3,10,0,79,9,198
20111008,52,3,9,1,3,2,47,7,124
20111009,20,2,7,0,1,0,28,3,61
20111010,56,10,19,3,7,0,67,12,174
20111011,58,15,23,2,9,2,89,14,212
20111012,35,1,18,0,2,0,42,9,107
20111013,90,7,24,2,5,2,129,17,276
20111014,112,11,29,3,7,1,174,22,359
20111015,87,8,28,1,6,1,130,17,278
20111016,18,3,6,4,2,0,29,2,64
20111017,62,10,32,1,16,0,101,13,235
20111018,70,7,13,1,5,0,100,19,215
20111019,57,6,23,2,2,2,84,9,185
20111020,65,2,27,4,4,0,91,13,206
20111021,68,7,24,1,4,1,114,21,240
20111022,55,2,13,4,8,2,67,11,162
20111023,19,4,11,1,3,0,24,5,67
20111024,65,13,20,2,5,1,92,12,210
20111025,72,5,21,2,7,2,93,15,217
20111026,70,6,13,2,5,1,95,11,203
20111027,61,7,23,0,3,0,88,16,198
20111028,60,10,22,4,4,0,79,19,198
20111029,55,9,19,1,2,1,56,5,148
20111030,12,0,7,1,2,0,23,6,51
20111031,57,5,21,7,5,0,88,9,192
20111101,65,2,24,2,9,2,87,9,200
20111102,43,3,8,1,9,0,59,4,127
20111103,54,8,23,6,3,0,76,11,181
20111104,59,8,22,2,10,0,92,14,207
20111105,79,8,25,0,9,1,105,14,241
20111106,24,3,5,1,5,0,36,3,77
20111107,60,7,23,3,7,0,88,12,200
20111108,70,5,24,3,7,1,84,14,208
20111109,57,5,31,3,8,1,89,12,206
20111110,104,8,44,5,12,1,188,34,396
20111111,117,9,45,11,11,1,179,34,407
20111112,107,11,41,1,7,0,156,19,342
20111113,70,3,27,3,4,1,78,9,195
20111114,132,16,40,2,16,1,157,35,399
20111115,85,13,24,3,13,1,150,16,305
20111116,87,12,37,2,7,2,137,23,307
20111117,90,8,34,1,9,0,150,18,310
20111118,91,12,43,5,6,0,129,27,313
20111119,74,17,22,3,9,0,97,13,235
20111120,28,2,13,1,8,0,40,7,99
20111121,87,17,31,5,5,0,124,21,290
20111122,142,22,44,5,18,0,170,28,429
20111123,79,5,34,1,8,3,136,19,285
20111124,91,10,35,4,8,2,134,16,300
20111125,163,16,46,4,17,0,204,28,478
20111126,104,12,36,3,13,2,171,13,354
20111127,39,8,19,0,8,0,53,6,133
20111128,84,16,41,1,13,1,104,12,272
20111129,81,9,41,3,9,3,135,24,305
20111130,90,15,40,3,16,2,138,17,321
20111201,93,7,27,3,8,0,99,11,248
20111202,72,10,34,5,16,1,130,17,285
20111203,59,3,21,6,9,0,83,15,196
20111204,28,3,9,0,4,0,33,8,85
20111205,67,5,31,2,7,0,100,11,223
20111206,58,2,23,2,11,0,97,13,206
20111207,84,3,23,3,7,1,90,11,222
20111208,75,8,30,1,9,0,116,19,258
20111209,62,4,30,1,8,0,98,12,215
20111210,44,4,21,5,5,0,71,10,160
20111211,57,3,15,1,3,0,60,10,149
20111212,67,5,33,5,8,1,113,11,243
20111213,55,14,23,6,7,1,104,14,224
20111214,65,7,31,4,8,0,104,18,237
20111215,58,11,30,3,13,1,98,12,226
20111216,72,5,24,4,6,0,110,15,236
20111217,67,10,19,0,5,0,96,10,207
20111218,31,3,10,2,3,1,44,11,105
20111219,47,7,35,1,6,1,86,7,190
20111220,60,9,31,2,12,1,97,7,219
20111221,77,8,23,1,4,0,91,10,214
20111222,56,5,24,1,7,2,61,20,176
20111223,66,12,23,5,9,0,96,11,222
20111224,43,4,12,2,7,1,57,8,134
20111225,6,1,1,0,1,0,15,1,25
20111226,44,5,14,0,5,1,43,8,120
20111227,88,11,24,2,8,0,120,15,268
20111228,72,6,32,3,9,0,125,15,262
20111229,90,12,35,1,8,0,142,23,311
20111230,87,16,35,2,11,0,141,22,314
20111231,85,8,43,3,5,0,116,16,276
20120101,0,0,0,0,0,0,0,0,0
20120102,49,6,17,2,6,0,62,12,154
20120103,62,6,21,5,5,0,89,10,198
20120104,67,5,13,4,7,0,109,9,214
20120105,69,8,29,2,5,1,99,16,229
20120106,75,6,34,4,6,1,129,18,273
20120107,46,13,19,1,5,2,98,8,192
20120108,15,1,7,1,0,0,25,6,55
20120109,73,8,26,2,9,3,92,13,226
20120110,67,8,27,1,14,4,102,11,234
20120111,111,7,48,5,12,1,134,18,336
20120112,75,8,44,6,6,3,104,17,263
20120113,80,7,31,2,13,2,132,10,277
20120114,54,6,12,7,6,1,64,11,161
20120115,20,6,7,0,1,0,38,2,74
20120116,64,12,26,4,8,0,105,14,233
20120117,72,5,28,4,11,1,115,17,253
20120118,63,3,26,3,4,0,120,20,239
20120119,72,11,31,2,10,0,112,17,255
20120120,30,2,6,1,4,0,36,5,84
20120121,37,5,15,3,4,0,67,9,140
20120122,18,2,6,0,3,0,20,6,55
20120123,74,9,32,3,11,0,91,24,244
20120124,70,9,23,0,17,1,121,14,255
20120125,118,7,32,4,12,4,161,18,356
20120126,123,10,32,3,15,2,164,30,379
20120127,105,11,37,5,11,1,147,22,339
20120128,84,6,29,3,4,2,97,25,250
20120129,38,3,13,2,0,1,42,6,105
20120130,101,10,40,1,12,1,169,16,350
20120131,99,13,24,1,4,2,164,29,336
20120201,69,16,37,0,8,1,104,18,253
20120202,80,5,15,4,7,1,92,23,227
20120203,67,6,33,1,5,0,119,19,250
20120204,48,5,14,4,9,0,77,12,169
20120205,23,2,11,1,2,0,24,4,67
20120206,61,6,25,2,9,0,108,20,231
20120207,76,4,28,0,6,1,97,9,221
20120208,93,8,43,7,11,0,143,16,321
20120209,67,8,38,2,8,1,121,11,256
20120210,62,11,26,1,10,1,94,15,220
20120211,113,12,32,6,9,1,151,27,351
20120212,29,3,12,5,3,0,49,8,109
20120213,96,11,38,2,16,1,133,26,323
20120214,96,12,37,2,17,2,137,15,318
20120215,114,15,40,5,7,1,143,21,346
20120216,88,14,29,2,15,2,135,19,304
20120217,92,6,33,6,4,0,141,20,302
20120218,59,6,11,1,4,0,75,5,161
20120219,28,2,6,0,0,0,30,4,70
20120220,46,5,21,2,7,1,56,11,149
20120221,36,3,20,0,2,1,53,5,120
20120222,33,4,28,4,4,0,57,10,140
20120223,59,8,28,2,10,0,87,11,205
20120224,74,15,27,4,6,0,123,13,262
20120225,55,4,23,3,4,0,68,9,166
20120226,17,1,13,1,2,0,29,6,69
20120227,65,9,30,2,13,3,102,15,239
20120228,73,7,26,5,5,1,106,18,241
20120229,69,5,24,3,5,4,96,16,222
20120301,60,4,20,0,4,0,88,6,182
20120302,65,10,17,0,4,0,90,11,197
20120303,38,8,17,0,6,0,78,11,158
20120304,17,0,8,0,5,0,30,7,67
20120305,89,5,29,3,8,0,89,17,240
20120306,50,5,24,1,7,0,89,9,185
20120307,70,8,20,1,10,2,128,11,250
20120308,89,12,27,1,8,1,102,11,251
20120309,52,3,21,2,6,0,83,19,186
20120310,105,7,23,2,11,2,151,10,311
20120311,30,8,6,0,4,0,29,6,83
20120312,75,8,37,2,7,1,79,16,225
20120313,64,7,21,2,6,0,109,12,221
20120314,68,6,29,2,7,1,107,11,231
20120315,57,8,23,1,9,1,110,10,219
20120316,81,11,26,5,11,0,91,11,236
20120317,86,13,20,1,10,4,109,16,259
20120318,26,2,8,2,2,0,27,7,74
20120319,91,13,30,5,15,2,107,17,280
20120320,85,9,29,4,5,2,141,24,299
20120321,68,15,32,2,10,1,105,5,238
20120322,83,4,23,3,11,0,84,10,218
20120323,74,13,33,6,10,1,116,22,275
20120324,100,13,30,4,7,0,145,20,319
20120325,34,6,8,2,3,0,42,4,99
20120326,87,15,26,3,4,0,119,15,269
20120327,94,14,35,1,11,1,131,24,311
20120328,84,11,38,6,14,2,139,20,314
20120329,75,10,24,2,5,2,108,16,242
20120330,85,9,29,2,12,1,135,19,292
20120331,75,10,25,5,9,0,124,13,261
20120401,22,1,10,0,1,0,24,9,67
20120402,58,7,14,2,6,2,102,13,204
20120403,63,6,16,0,5,0,71,10,171
20120404,48,6,13,3,6,0,60,10,146
20120405,67,1,32,5,6,1,95,14,221
20120406,18,3,9,0,2,0,30,3,65
20120407,55,8,16,4,2,0,81,11,177
20120408,4,3,5,1,1,0,23,7,44
20120409,81,6,24,3,8,0,112,10,244
20120410,74,9,30,2,12,2,120,8,257
20120411,70,6,28,2,6,1,120,12,245
20120412,52,8,19,1,9,0,88,13,190
20120413,71,17,26,0,9,0,110,16,249
20120414,70,12,25,0,4,0,120,12,243
20120415,30,5,9,3,2,0,45,7,101
20120416,57,7,27,1,4,0,92,15,203
20120417,72,9,32,3,15,0,105,11,247
20120418,91,10,34,3,8,0,108,19,273
20120419,99,10,20,5,7,0,119,19,279
20120420,79,8,33,4,6,3,103,11,247
20120421,42,3,13,1,4,2,68,10,143
20120422,12,0,7,0,1,0,31,2,53
20120423,29,6,12,0,7,0,48,9,111
20120424,82,6,23,2,13,0,105,19,250
20120425,87,7,26,4,3,0,114,15,256
20120426,57,7,18,2,10,0,106,8,208
20120427,58,8,32,2,5,1,110,19,235
20120428,57,5,28,3,10,0,81,12,196
20120429,27,2,4,1,3,0,49,0,86
20120430,65,7,24,4,6,1,89,17,213
20120501,27,0,11,1,4,1,38,6,88
20120502,59,6,18,1,7,0,71,10,172
20120503,38,10,17,0,6,1,64,11,147
20120504,67,7,26,3,12,0,111,20,246
20120505,73,10,24,1,12,1,106,6,233
20120506,20,2,5,0,4,0,29,5,65
20120507,54,6,21,3,8,1,107,10,210
20120508,60,4,26,4,16,0,96,10,216
20120509,94,8,24,2,10,1,133,11,283
20120510,73,10,25,4,9,1,116,14,252
20120511,79,4,22,1,7,1,86,18,218
20120512,51,6,20,3,6,0,80,21,187
20120513,21,1,12,1,2,1,36,9,83
20120514,88,9,34,3,7,0,138,19,298
20120515,81,11,37,3,12,2,123,17,286
20120516,88,5,25,2,7,0,108,19,254
20120517,71,7,33,1,13,1,103,23,252
20120518,60,9,28,6,7,2,108,15,235
20120519,62,10,27,3,8,0,94,15,219
20120520,32,6,13,0,1,0,44,8,104
20120521,81,8,25,3,7,1,132,20,277
20120522,80,16,24,2,5,2,128,18,275
20120523,101,11,31,3,11,0,147,11,315
20120524,84,9,40,4,5,0,119,19,280
20120525,80,10,29,5,11,0,118,23,276
20120526,92,10,30,3,7,0,142,21,305
20120527,34,3,17,3,8,0,52,8,125
20120528,88,12,34,4,12,1,120,16,287
20120529,92,16,35,3,8,3,125,16,298
20120530,85,6,30,4,11,0,131,18,285
20120531,60,5,31,2,8,0,93,19,218
20120601,73,6,22,6,7,1,100,26,241
20120602,60,8,21,2,5,1,109,10,216
20120603,24,6,9,2,3,0,32,7,83
20120604,70,4,24,4,10,1,84,14,211
20120605,49,4,18,2,2,0,104,14,193
20120606,51,7,19,2,2,1,90,18,190
20120607,47,0,13,0,1,0,55,9,125
20120608,70,10,27,2,5,2,90,18,224
20120609,44,5,10,0,4,0,53,12,128
20120610,13,1,5,1,3,0,25,2,50
20120611,79,5,29,2,9,0,108,14,246
20120612,116,12,42,3,9,0,149,25,356
20120613,63,8,29,3,8,0,93,9,213
20120614,116,18,48,5,11,2,154,20,374
20120615,68,3,22,4,7,0,119,21,244
20120616,109,8,33,3,8,0,123,19,303
20120617,21,4,3,0,1,0,26,11,66
20120618,77,5,25,5,7,1,103,14,237
20120619,60,4,32,2,9,0,93,15,215
20120620,53,4,31,0,3,0,76,7,174
20120621,50,9,11,4,7,1,69,10,161
20120622,64,2,26,3,10,1,85,12,203
20120623,45,3,15,3,5,0,76,7,154
20120624,28,1,14,1,4,0,51,4,103
20120625,61,7,36,3,10,0,85,12,214
20120626,53,3,18,1,8,0,62,16,161
20120627,69,5,24,3,6,0,80,10,197
20120628,68,8,23,4,7,1,111,19,241
20120629,54,9,17,3,7,2,94,13,199
20120630,63,6,27,3,7,0,84,12,202
20120701,37,9,13,1,4,2,28,11,105
20120702,56,6,22,1,4,0,82,15,186
20120703,82,10,39,2,8,0,130,15,286
20120704,74,17,25,3,7,0,108,19,253
20120705,57,7,22,2,4,0,75,27,194
20120706,57,6,20,3,4,0,90,11,191
20120707,75,10,23,5,9,1,101,16,240
20120708,27,2,11,3,3,0,23,1,70
20120709,45,8,19,4,4,1,101,14,196
20120710,68,12,27,2,8,1,98,18,234
20120711,59,10,24,1,7,1,108,8,218
20120712,97,12,25,4,15,1,113,12,279
20120713,64,3,22,2,10,1,81,15,198
20120714,83,9,20,3,5,1,91,16,228
20120715,24,1,4,2,0,0,17,3,51
20120716,49,3,29,1,5,1,87,12,187
20120717,88,10,33,0,5,0,130,21,287
20120718,73,6,19,2,7,0,109,14,230
20120719,62,5,27,2,4,1,94,14,209
20120720,54,5,20,1,4,0,87,8,179
20120721,60,4,27,0,4,2,85,11,193
20120722,21,2,10,2,2,0,26,7,70
20120723,45,12,20,3,5,1,83,13,182
20120724,58,8,17,2,8,0,73,5,171
20120725,89,12,26,4,5,0,122,15,273
20120726,81,9,35,4,14,1,158,17,319
20120727,65,7,29,1,7,2,102,11,224
20120728,47,5,29,1,5,2,68,15,172
20120729,43,6,12,0,4,0,44,6,115
20120730,65,8,41,9,10,0,111,17,261
20120731,76,9,31,4,10,2,114,24,270
20120801,71,6,19,2,5,0,94,9,206
20120802,92,11,25,2,7,2,119,17,275
20120803,53,4,23,4,5,0,104,13,206
20120804,44,5,16,1,9,0,73,13,161
20120805,20,1,10,1,2,0,29,6,69
20120806,68,11,32,2,7,0,98,15,233
20120807,70,6,25,6,10,2,93,12,224
20120808,79,9,19,5,6,1,104,16,239
20120809,70,13,20,2,9,2,96,16,228
20120810,54,9,29,1,5,1,98,12,209
20120811,55,7,26,4,8,0,74,20,194
20120812,22,2,13,1,4,1,32,7,82
20120813,68,11,30,0,10,1,100,18,238
20120814,63,11,14,7,9,1,102,23,230
20120815,86,10,24,2,8,1,108,13,252
20120816,73,9,41,2,8,1,120,15,269
20120817,87,6,30,6,11,0,134,23,297
20120818,71,6,21,0,6,2,99,9,214
20120819,24,6,12,0,2,1,42,8,95
20120820,74,3,27,3,6,3,109,15,240
20120821,90,7,24,5,7,2,131,17,283
20120822,113,14,34,4,7,1,142,16,331
20120823,84,3,33,4,9,1,130,24,288
20120824,102,15,40,4,8,1,115,13,298
20120825,48,5,12,6,9,1,73,20,174
20120826,22,0,12,1,0,1,30,7,73
20120827,104,12,25,4,8,0,138,17,308
20120828,62,9,34,2,6,0,97,10,220
20120829,80,13,30,3,10,1,116,25,278
20120830,59,4,17,3,6,2,74,15,180
20120831,75,9,32,1,9,1,110,17,254
20120901,45,4,29,1,4,0,60,11,154
20120902,31,0,7,2,2,0,33,3,78
20120903,63,7,20,4,8,1,91,10,204
20120904,67,10,43,4,7,0,93,18,242
20120905,62,9,15,0,2,0,72,12,172
20120906,92,7,27,3,17,2,132,15,295
20120907,27,1,11,0,1,0,25,4,69
20120908,27,10,16,2,4,0,60,6,125
20120909,9,0,6,1,1,0,16,1,34
20120910,76,10,36,3,11,3,103,19,261
20120911,73,5,34,0,7,0,109,20,248
20120912,74,10,19,4,4,1,83,12,207
20120913,43,6,21,2,7,0,82,11,172
20120914,59,10,19,0,10,1,89,17,205
20120915,45,2,19,2,1,0,70,10,149
20120916,22,0,6,0,1,0,26,9,64
20120917,78,10,28,2,10,1,92,16,237
20120918,56,9,16,0,10,0,69,10,170
20120919,61,6,19,4,12,1,92,11,206
20120920,49,6,15,1,7,0,65,8,151
20120921,73,9,29,1,9,0,73,18,212
20120922,54,8,14,1,3,0,57,4,141
20120923,24,3,16,1,1,1,22,2,70
20120924,81,11,18,1,7,1,90,18,227
20120925,65,5,16,4,5,0,93,18,206
20120926,47,7,20,0,5,1,76,16,172
20120927,80,15,36,3,6,0,117,19,276
20120928,73,10,24,1,6,1,118,11,244
20120929,58,3,20,1,0,1,74,13,170
20120930,14,1,4,1,4,0,25,3,52
20121001,61,9,29,3,9,1,100,7,219
20121002,84,10,40,1,12,0,128,21,296
20121003,87,13,28,8,12,1,158,20,327
20121004,84,11,50,4,13,0,137,25,324
20121005,70,6,20,4,5,0,114,20,239
20121006,71,7,22,0,3,1,101,15,220
20121007,16,2,5,0,5,0,25,6,59
20121008,77,11,26,1,9,1,130,15,270
20121009,80,16,30,3,4,1,140,22,296
20121010,117,11,34,4,10,3,133,18,330
20121011,85,8,40,5,7,1,114,18,278
20121012,53,4,22,2,7,1,75,14,178
20121013,39,4,20,5,3,0,84,15,170
20121014,43,4,5,2,5,0,38,6,103
20121015,109,14,37,3,8,0,150,26,347
20121016,70,10,31,0,5,0,108,16,240
20121017,77,14,32,6,11,3,153,21,317
20121018,55,7,26,1,9,1,90,17,206
20121019,83,7,20,3,10,3,104,13,243
20121020,55,7,22,2,3,2,83,9,183
20121021,24,4,7,1,3,0,31,3,73
20121022,83,11,37,4,7,1,152,20,315
20121023,101,13,33,4,10,0,135,21,317
20121024,103,10,38,2,13,1,147,27,341
20121025,91,10,27,5,5,1,133,20,292
20121026,72,13,30,7,10,0,139,11,282
20121027,45,7,13,0,10,0,65,10,150
20121028,22,1,9,0,2,0,31,5,70
20121029,67,8,17,0,13,1,109,12,227
20121030,75,5,35,4,10,0,106,15,250
20121031,83,11,35,2,5,0,119,20,275
20121101,63,5,28,4,6,1,90,9,206
20121102,39,6,10,1,1,0,40,9,106
20121103,36,6,26,0,6,0,64,11,149
20121104,18,3,8,2,1,0,19,7,58
20121105,75,10,23,4,9,2,81,16,220
20121106,79,5,28,2,9,0,132,11,266
20121107,66,8,27,1,4,0,81,13,200
20121108,72,11,31,3,8,0,115,10,250
20121109,69,15,19,2,7,1,115,17,245
20121110,40,5,31,3,2,1,68,7,157
20121111,22,1,9,3,1,0,21,7,64
20121112,58,11,28,3,12,0,96,16,224
20121113,74,10,28,2,6,1,109,21,251
20121114,54,12,29,1,7,1,101,12,217
20121115,43,2,22,2,4,0,56,12,141
20121116,70,7,27,2,10,0,87,15,218
20121117,37,2,19,0,10,1,50,7,126
20121118,12,1,5,0,1,0,29,4,52
20121119,67,10,31,1,8,1,102,20,240
20121120,31,6,21,0,4,0,48,10,120
20121121,150,20,47,1,22,0,211,32,483
20121122,185,28,59,6,23,1,258,31,591
20121123,98,11,28,3,8,0,131,20,299
20121124,85,19,25,2,10,1,107,9,258
20121125,54,7,18,0,5,1,80,14,179
20121126,90,9,33,2,15,2,119,19,289
20121127,75,7,27,5,7,1,125,14,261
20121128,102,12,24,7,8,0,129,17,299
20121129,57,17,38,4,4,2,96,13,231
20121130,76,10,26,1,11,1,117,13,255
20121201,79,15,13,6,6,2,96,15,232
20121202,17,3,7,3,5,0,28,11,74
20121203,90,10,32,4,10,1,108,11,266
20121204,85,8,36,2,5,2,112,21,271
20121205,71,13,21,1,12,1,120,15,254
20121206,85,9,28,1,15,2,131,22,293
20121207,54,7,25,3,4,0,85,8,186
20121208,42,3,19,1,4,1,61,12,143
20121209,20,1,7,1,2,0,29,6,66
20121210,53,7,31,2,6,1,109,14,223
20121211,78,11,18,4,4,0,85,13,213
20121212,48,8,22,1,3,0,89,19,190
20121213,50,6,35,2,1,0,94,13,201
20121214,60,4,21,0,9,0,96,13,203
20121215,57,6,12,2,4,0,70,8,159
20121216,22,2,17,1,3,0,29,4,78
20121217,75,9,32,0,5,1,109,11,242
20121218,76,10,27,4,8,0,82,19,226
20121219,48,5,29,2,6,1,65,8,164
20121220,70,8,16,2,3,0,89,10,198
20121221,48,9,18,2,3,0,84,6,170
20121222,41,5,10,3,6,1,51,6,123
20121223,17,1,13,1,4,0,27,6,69
20121224,46,2,13,3,1,0,50,6,121
20121225,8,3,3,2,2,0,10,3,31
20121226,28,1,7,1,4,0,40,7,88
20121227,59,8,27,1,4,0,70,13,182
20121228,91,10,29,5,11,0,127,18,291
20121229,53,5,21,4,4,0,91,14,192
20121230,25,1,7,0,4,0,39,5,81
20121231,93,8,27,2,6,0,149,14,299
20130101,0,0,0,0,0,0,0,0,0
20130102,77,3,22,1,4,1,113,10,231
20130103,45,6,18,2,7,1,89,6,174
20130104,87,7,36,2,12,1,143,19,307
20130105,58,8,23,1,3,0,82,8,183
20130106,28,1,12,1,7,0,36,8,93
20130107,60,11,32,1,8,0,93,17,222
20130108,66,12,16,3,3,0,113,21,234
20130109,73,10,22,2,7,0,103,19,236
20130110,81,8,21,3,11,2,106,15,247
20130111,76,6,30,0,14,3,90,20,239
20130112,64,15,25,3,9,1,112,14,243
20130113,38,4,10,1,8,0,31,6,98
20130114,78,9,43,2,7,0,136,23,298
20130115,82,10,40,2,9,2,128,19,292
20130116,92,8,34,4,11,1,124,18,292
20130117,66,9,36,3,9,0,111,16,250
20130118,61,8,23,1,4,2,101,12,212
20130119,66,4,22,5,4,0,97,9,207
20130120,29,4,9,0,3,0,44,6,95
20130121,59,8,28,2,5,0,100,16,218
20130122,68,10,19,2,12,1,96,10,218
20130123,98,16,38,1,10,0,127,19,309
20130124,76,4,23,3,13,0,102,13,234
20130125,60,8,28,2,5,2,95,20,220
20130126,63,4,27,3,7,1,99,13,217
20130127,29,4,11,0,4,0,55,10,113
20130128,97,3,38,3,9,2,137,17,306
20130129,126,13,57,5,11,4,172,30,418
20130130,105,17,48,5,14,0,153,20,362
20130131,112,9,39,1,10,0,154,24,349
20130201,116,13,41,4,20,1,189,24,408
20130202,80,10,23,2,8,0,110,18,251
20130203,26,2,6,2,2,2,41,10,91
20130204,114,20,51,3,11,0,117,19,335
20130205,92,12,25,2,11,0,123,17,282
20130206,132,19,44,2,12,0,184,22,415
20130207,112,18,34,3,10,0,150,18,345
20130208,96,6,22,2,5,0,110,22,263
20130209,59,1,11,4,9,1,55,10,150
20130210,21,2,7,0,2,0,29,2,63
20130211,36,5,13,2,7,0,61,9,133
20130212,24,3,3,1,3,1,22,5,62
20130213,42,8,8,1,3,0,70,7,139
20130214,43,7,24,1,8,1,72,10,166
20130215,51,5,21,0,7,2,83,14,183
20130216,27,3,8,1,6,0,51,9,105
20130217,22,1,3,1,2,0,16,1,46
20130218,53,7,24,4,7,1,98,14,208
20130219,48,6,30,1,7,0,89,15,196
20130220,56,7,26,2,11,1,86,14,203
20130221,73,6,26,1,10,2,103,8,229
20130222,52,7,30,1,4,0,87,17,198
20130223,55,7,16,2,3,0,72,18,173
20130224,34,7,11,1,0,0,29,11,93
20130225,73,5,32,6,9,0,114,26,265
20130226,57,5,30,2,5,1,78,19,197
20130227,64,5,15,2,4,1,80,15,186
20130228,56,3,26,2,8,2,71,13,181
20130301,47,9,29,4,2,1,77,6,175
20130302,54,7,14,3,7,0,69,5,159
20130303,20,2,8,0,4,0,34,8,76
20130304,85,12,40,3,9,1,88,20,258
20130305,61,6,29,4,6,1,105,24,236
20130306,66,6,32,4,11,0,108,16,243
20130307,86,7,19,4,5,1,113,10,245
20130308,97,10,24,3,15,1,112,24,286
20130309,61,5,17,1,7,1,96,7,195
20130310,17,4,6,0,3,0,34,6,70
20130311,91,7,26,1,8,1,143,13,290
20130312,72,5,33,3,10,1,111,12,247
20130313,85,7,19,3,9,1,107,15,246
20130314,72,5,17,2,9,0,83,7,195
20130315,85,15,25,5,9,1,139,18,297
20130316,57,10,24,3,3,0,78,13,188
20130317,28,5,10,0,0,1,39,11,94
20130318,54,2,18,1,3,0,81,11,170
20130319,56,8,10,4,4,1,83,5,171
20130320,54,6,15,1,4,2,63,14,159
20130321,46,3,26,0,8,1,68,11,163
20130322,58,7,21,6,5,0,88,16,201
20130323,63,4,29,3,5,1,112,8,225
20130324,27,3,9,1,4,0,34,7,85
20130325,66,9,27,1,10,0,85,16,214
20130326,58,4,27,0,7,0,82,16,194
20130327,45,10,23,1,5,0,78,12,174
20130328,46,7,28,4,5,0,80,14,184
20130329,18,3,10,2,3,0,22,1,59
20130330,64,14,32,3,8,0,101,16,238
20130331,23,5,9,2,3,0,36,4,82
20130401,68,9,34,2,7,3,102,14,239
20130402,83,3,31,3,10,0,114,14,258
20130403,80,6,30,4,6,1,86,10,223
20130404,90,10,24,1,9,2,110,17,263
20130405,71,7,34,3,4,1,109,14,243
20130406,46,4,28,2,12,2,90,9,193
20130407,19,3,6,1,4,1,33,2,69
20130408,58,4,31,3,8,0,103,18,225
20130409,76,3,27,5,5,0,124,15,255
20130410,98,10,31,8,12,2,119,22,302
20130411,84,10,48,3,9,0,149,22,325
20130412,60,6,12,8,9,0,112,9,216
20130413,58,10,16,1,9,1,83,14,192
20130414,31,6,9,0,7,0,50,6,109
20130415,71,9,20,2,4,0,108,15,229
20130416,74,6,34,3,12,2,136,14,281
20130417,83,17,28,4,8,1,133,24,298
20130418,70,5,28,5,6,0,95,30,239
20130419,96,14,21,10,7,0,96,17,261
20130420,44,7,25,2,7,0,66,6,157
20130421,29,2,8,1,1,0,46,5,92
20130422,80,9,26,4,7,1,86,18,231
20130423,49,5,24,4,4,0,48,10,144
20130424,50,6,21,1,8,0,72,15,173
20130425,74,8,22,1,5,2,90,23,225
20130426,55,4,15,0,4,1,75,15,169
20130427,45,8,14,3,3,2,63,16,154
20130428,14,3,7,1,1,0,27,4,57
20130429,59,9,41,4,8,1,102,18,242
20130430,104,9,26,3,15,3,132,21,313
20130501,33,6,14,5,2,0,75,10,145
20130502,58,6,28,1,4,0,85,14,196
20130503,66,4,21,1,7,0,101,18,218
20130504,63,2,18,0,5,0,77,15,180
20130505,26,0,17,2,7,0,63,4,119
20130506,63,7,19,2,4,2,94,16,207
20130507,62,4,19,3,4,0,104,17,213
20130508,76,9,30,3,7,0,118,17,260
20130509,70,14,21,6,7,0,110,20,248
20130510,82,6,27,5,12,1,99,17,249
20130511,66,8,25,0,9,1,85,7,201
20130512,25,1,7,0,1,0,37,4,75
20130513,72,10,30,2,6,1,111,13,245
20130514,76,10,30,0,11,1,147,19,294
20130515,79,7,29,2,9,1,124,15,266
20130516,82,6,37,2,11,1,151,24,314
20130517,72,10,28,1,5,0,113,20,249
20130518,47,4,19,1,4,0,89,13,177
20130519,21,2,5,0,2,0,45,4,79
20130520,65,9,28,2,14,0,104,15,237
20130521,65,5,33,1,6,0,110,19,239
20130522,69,6,29,0,8,1,100,14,227
20130523,77,6,30,3,3,0,105,11,235
20130524,70,7,25,1,1,0,100,13,217
20130525,52,1,19,3,9,0,72,8,164
20130526,29,3,7,1,4,1,29,2,76
20130527,81,7,27,5,13,1,127,16,277
20130528,90,9,25,1,14,1,106,14,260
20130529,60,6,15,2,6,0,85,13,187
20130530,43,3,9,0,9,0,43,8,115
20130531,77,2,27,4,7,2,108,12,239
20130601,43,5,21,2,7,0,75,9,162
20130602,24,2,5,2,3,0,29,3,68
20130603,43,7,19,4,4,0,73,10,160
20130604,73,12,24,4,9,1,120,9,252
20130605,72,10,27,2,8,3,102,6,230
20130606,65,4,21,3,8,0,81,7,189
20130607,48,6,31,3,7,2,86,11,194
20130608,33,5,14,0,3,0,56,7,118
20130609,20,3,6,1,1,0,29,6,66
20130610,76,5,25,2,11,0,115,20,254
20130611,57,7,21,2,8,1,103,17,216
20130612,81,7,28,5,14,0,112,14,261
20130613,83,5,36,1,11,1,129,12,278
20130614,84,8,25,6,15,0,142,17,297
20130615,70,5,24,4,7,1,113,19,243
20130616,24,2,11,2,2,0,36,9,86
20130617,88,11,19,4,8,2,166,16,314
20130618,81,7,30,2,8,1,119,18,266
20130619,74,7,22,2,3,0,101,7,216
20130620,65,1,21,2,5,1,83,6,184
20130621,57,9,23,1,10,2,71,11,184
20130622,36,5,17,4,6,1,55,12,136
20130623,25,4,10,1,3,0,34,4,81
20130624,82,11,33,4,7,1,92,13,243
20130625,80,6,29,3,14,1,113,14,260
20130626,72,11,22,0,6,1,99,11,222
20130627,64,6,31,1,5,1,79,7,194
20130628,62,9,28,2,5,1,102,8,217
20130629,70,3,27,4,5,0,85,8,202
20130630,31,4,14,0,4,0,36,3,92
20130701,46,8,18,2,2,1,72,10,159
20130702,93,10,24,2,5,1,114,20,269
20130703,67,6,29,8,8,0,99,16,233
20130704,74,12,24,3,10,0,127,25,275
20130705,65,7,21,3,6,1,98,16,217
20130706,52,8,22,2,7,3,94,10,198
20130707,21,5,5,1,2,0,23,1,58
20130708,66,10,23,3,7,0,104,9,222
20130709,60,11,21,5,7,1,106,15,226
20130710,93,14,45,5,4,2,133,15,311
20130711,28,4,11,1,7,1,55,7,114
20130712,42,7,18,2,3,0,72,11,155
20130713,55,5,23,2,12,1,74,10,182
20130714,17,1,6,2,2,0,35,3,66
20130715,53,3,20,3,5,0,80,11,175
20130716,66,8,20,0,9,1,94,10,208
20130717,80,6,32,9,10,0,135,24,296
20130718,89,17,31,4,4,0,126,19,290
20130719,87,6,23,1,8,1,116,17,259
20130720,68,7,14,3,7,2,100,13,214
20130721,23,4,11,2,2,0,30,4,76
20130722,49,4,22,1,3,0,81,8,168
20130723,45,3,15,0,4,0,59,10,136
20130724,58,8,13,2,4,0,65,14,164
20130725,27,2,14,2,1,0,41,8,95
20130726,37,4,11,0,5,2,54,8,121
20130727,37,2,10,4,11,0,58,8,130
20130728,14,2,7,0,2,1,13,2,41
20130729,53,5,27,4,6,1,71,9,176
20130730,89,8,21,2,9,0,98,16,243
20130731,64,10,26,4,7,2,105,17,235
20130801,63,7,23,1,6,3,108,24,235
20130802,80,3,27,1,5,1,87,11,215
20130803,74,11,22,6,6,1,117,15,252
20130804,16,2,4,1,4,0,26,14,67
20130805,67,6,29,0,7,4,96,12,221
20130806,58,9,15,3,9,1,68,10,173
20130807,59,11,26,3,13,1,99,16,228
20130808,67,11,30,1,7,0,101,16,233
20130809,56,11,16,3,8,0,101,9,204
20130810,65,5,20,1,5,0,90,13,199
20130811,25,4,8,1,0,0,36,3,77
20130812,71,12,24,0,5,1,90,10,213
20130813,71,6,22,0,8,0,103,11,221
20130814,74,8,24,5,4,0,112,29,256
20130815,66,7,21,3,4,2,94,20,217
20130816,47,5,19,1,6,0,86,20,184
20130817,77,6,26,3,7,3,104,16,242
20130818,26,2,11,0,6,0,46,8,99
20130819,77,10,28,3,9,1,124,13,265
20130820,73,11,39,5,6,1,83,14,232
20130821,73,7,31,5,8,2,125,13,264
20130822,65,4,21,2,8,0,92,12,204
20130823,86,9,30,1,10,2,115,19,272
20130824,59,4,24,5,7,1,78,8,186
20130825,26,1,5,1,5,0,30,8,76
20130826,81,15,36,5,9,1,106,12,265
20130827,66,7,21,2,8,1,61,12,178
20130828,82,10,35,8,12,0,141,20,308
20130829,83,6,21,2,5,1,105,13,236
20130830,62,8,16,4,5,0,73,7,175
20130831,56,8,15,1,9,0,81,12,182
20130901,16,1,9,3,0,1,21,3,54
20130902,39,5,20,1,3,0,71,11,150
20130903,46,6,18,2,7,0,81,8,168
20130904,51,7,14,3,7,0,78,6,166
20130905,41,2,10,3,9,1,45,10,121
20130906,55,6,26,0,8,2,77,6,180
20130907,18,5,11,0,3,1,23,3,64
20130908,14,2,9,1,1,0,28,8,63
20130909,81,8,30,5,6,2,120,16,268
20130910,61,4,25,1,3,0,97,19,210
20130911,67,6,31,1,2,1,91,12,211
20130912,78,5,17,1,5,0,98,15,219
20130913,82,11,30,7,8,2,122,17,279
20130914,61,7,12,4,4,0,99,15,202
20130915,16,2,7,0,3,1,29,3,61
20130916,53,4,20,0,5,0,93,9,184
20130917,82,6,27,4,5,0,101,7,232
20130918,67,4,17,5,7,2,112,12,226
20130919,78,12,20,6,7,1,114,19,257
20130920,66,7,22,4,5,0,90,17,211
20130921,94,10,28,9,6,2,99,10,258
20130922,22,2,3,1,1,1,18,3,51
20130923,64,10,22,1,11,2,99,16,225
20130924,59,8,28,3,1,2,75,12,188
20130925,72,12,34,3,13,1,96,17,248
20130926,90,9,27,1,8,1,117,19,272
20130927,91,6,24,6,15,0,124,19,285
20130928,53,4,12,2,5,2,77,9,164
20130929,15,1,11,1,0,0,31,6,65
20130930,86,6,30,5,9,1,91,13,241
20131001,63,7,34,2,9,1,103,14,233
20131002,54,4,17,0,7,0,58,4,144
20131003,62,6,17,4,7,0,85,10,191
20131004,53,5,28,4,6,2,76,9,183
20131005,42,6,12,4,6,0,60,9,139
20131006,29,3,8,0,4,0,48,10,102
20131007,69,9,22,1,6,2,97,18,224
20131008,61,6,18,0,7,0,83,12,187
20131009,88,10,24,4,5,0,109,23,263
20131010,81,7,27,1,8,1,104,18,247
20131011,68,6,20,4,7,1,88,16,210
20131012,46,4,6,1,2,1,42,8,110
20131013,13,3,8,2,1,0,18,3,48
20131014,78,14,16,1,8,0,92,18,227
20131015,78,10,37,1,6,1,129,19,281
20131016,53,6,23,4,3,2,70,14,175
20131017,65,13,27,4,8,0,99,20,236
20131018,60,9,22,2,5,3,102,13,216
20131019,38,3,23,5,3,0,64,11,147
20131020,23,1,2,1,1,0,18,9,55
20131021,70,7,27,2,7,0,94,14,221
20131022,66,6,23,7,7,0,96,11,216
20131023,60,11,18,3,7,0,93,10,202
20131024,42,3,26,2,4,0,81,8,166
20131025,60,5,30,3,9,0,87,13,207
20131026,41,8,17,1,7,0,75,8,157
20131027,22,3,2,1,0,0,18,2,48
20131028,50,5,18,2,7,2,103,12,199
20131029,58,8,16,2,7,1,110,14,216
20131030,75,9,34,4,10,1,108,18,259
20131031,42,5,25,1,6,1,103,9,192
20131101,61,5,28,3,7,1,98,16,219
20131102,58,9,20,2,5,0,78,13,185
20131103,22,1,7,1,1,1,33,0,66
20131104,63,8,20,0,5,1,78,14,189
20131105,52,3,16,3,5,2,79,14,174
20131106,47,5,18,1,4,1,67,7,150
20131107,38,2,16,6,5,0,71,12,150
20131108,62,8,17,2,3,1,80,9,182
20131109,58,5,19,4,5,2,71,15,179
20131110,20,3,6,0,0,0,35,8,72
20131111,76,9,34,1,11,1,113,20,265
20131112,45,4,23,1,8,0,72,6,159
20131113,68,10,27,2,5,0,100,17,229
20131114,61,10,24,3,7,1,60,11,177
20131115,22,0,9,1,2,0,44,3,81
20131116,38,2,8,3,6,0,67,8,132
20131117,20,1,2,0,0,0,14,1,38
20131118,70,10,22,0,7,0,80,4,193
20131119,41,4,17,1,3,0,67,11,144
20131120,38,2,17,1,5,1,59,13,136
20131121,42,3,18,0,8,0,49,12,132
20131122,52,9,18,4,6,1,71,10,171
20131123,52,6,14,0,6,0,81,13,172
20131124,35,2,6,0,2,1,38,10,94
20131125,167,20,46,5,11,0,220,41,510
20131126,164,24,55,3,22,2,259,33,562
20131127,71,7,29,5,10,0,121,12,255
20131128,71,11,28,2,5,1,83,11,212
20131129,75,8,32,2,12,1,112,19,261
20131130,74,5,28,2,9,0,104,16,238
20131201,26,1,13,0,2,0,35,7,84
20131202,66,7,21,1,6,1,101,15,218
20131203,59,11,21,1,9,0,78,12,191
20131204,48,3,19,2,8,1,94,13,188
20131205,55,13,23,1,6,0,94,19,211
20131206,79,7,27,2,8,0,103,18,244
20131207,64,11,21,1,6,1,79,15,198
20131208,22,3,6,1,5,0,34,4,75
20131209,56,7,24,3,7,1,74,10,182
20131210,49,5,17,3,7,0,60,5,146
20131211,12,0,10,0,1,1,31,6,61
20131212,69,4,16,2,3,1,73,13,181
20131213,53,4,9,5,5,1,58,10,145
20131214,72,6,18,2,9,1,101,5,214
20131215,24,1,6,2,2,1,36,3,75
20131216,51,9,24,2,4,2,84,14,190
20131217,67,5,15,3,3,1,79,11,184
20131218,62,9,26,3,6,0,70,11,187
20131219,41,4,18,3,3,1,56,14,140
20131220,71,5,27,3,9,0,93,16,224
20131221,41,6,19,0,4,2,73,10,155
20131222,17,2,2,0,2,0,32,3,58
20131223,43,4,15,3,6,2,59,11,143
20131224,50,11,18,4,3,3,59,7,155
20131225,8,4,6,1,0,0,17,1,37
20131226,61,8,18,5,4,0,77,10,183
20131227,64,5,33,5,8,1,113,15,244
20131228,53,3,20,2,8,1,77,11,175
20131229,27,2,10,2,1,1,37,5,85
20131230,81,9,25,4,7,0,103,27,256
20131231,96,12,41,1,13,1,162,13,339
20140101,0,0,0,0,0,0,0,0,0
20140102,44,2,24,0,8,0,87,9,174
20140103,77,10,29,1,1,0,86,5,209
20140104,52,5,15,3,9,1,63,9,157
20140105,17,2,3,1,1,0,18,11,53
20140106,47,7,18,7,9,0,67,12,167
20140107,65,9,18,4,9,2,91,19,217
20140108,45,5,15,2,9,1,72,14,163
20140109,50,5,20,2,9,1,76,11,174
20140110,75,12,26,1,6,1,92,13,226
20140111,50,7,19,3,3,0,57,5,144
20140112,16,2,5,2,1,0,25,2,53
20140113,66,7,24,2,9,0,100,9,217
20140114,47,3,26,1,9,1,83,11,181
20140115,68,7,24,4,6,1,94,13,217
20140116,62,5,32,2,10,1,97,10,219
20140117,80,6,28,3,8,0,93,9,227
20140118,47,7,14,3,2,0,81,11,165
20140119,22,2,8,1,1,0,24,9,67
20140120,43,6,10,2,2,1,48,8,120
20140121,57,4,28,0,7,0,101,17,214
20140122,56,2,27,3,9,2,80,9,188
20140123,67,8,14,2,2,0,82,11,186
20140124,59,9,30,4,8,0,72,16,198
20140125,108,11,34,4,17,2,172,22,370
20140126,35,0,10,1,5,0,39,10,100
20140127,74,9,23,3,13,1,109,11,243
20140128,69,5,31,5,7,1,111,23,252
20140129,56,6,32,5,5,0,78,11,193
20140130,66,1,25,7,5,0,103,10,217
20140131,68,5,28,2,8,1,121,17,250
20140201,111,16,50,4,19,0,164,25,389
20140202,19,6,19,1,0,1,37,9,92
20140203,66,3,23,2,4,0,94,15,207
20140204,50,4,15,3,8,1,62,13,156
20140205,69,12,37,4,9,1,123,18,273
20140206,75,6,30,0,3,1,78,18,211
20140207,62,7,23,2,6,0,110,19,229
20140208,57,11,24,3,5,1,96,12,209
20140209,29,6,10,2,1,1,73,10,132
20140210,75,13,38,3,4,0,103,17,253
20140211,64,7,15,4,1,1,87,10,189
20140212,77,10,56,3,7,0,124,17,294
20140213,59,8,30,5,5,2,123,19,251
20140214,59,18,23,4,6,1,105,12,228
20140215,66,5,25,1,6,4,108,11,226
20140216,15,3,9,0,2,0,38,5,72
20140217,87,10,32,4,12,1,117,18,281
20140218,48,5,25,1,7,2,71,11,170
20140219,88,7,27,3,6,0,116,16,263
20140220,65,5,26,2,6,2,95,10,211
20140221,76,8,29,5,5,1,96,9,229
20140222,69,8,22,2,5,1,112,17,236
20140223,30,3,13,1,2,0,46,9,104
20140224,77,7,35,3,8,0,93,10,233
20140225,59,11,21,3,8,3,109,9,223
20140226,115,11,22,5,10,5,127,12,307
20140227,83,10,37,6,10,0,120,18,284
20140228,61,9,21,6,5,2,107,16,227
20140301,48,4,17,0,1,1,63,5,139
20140302,29,3,15,1,1,0,39,8,96
20140303,67,6,22,3,5,0,111,12,226
20140304,38,5,16,3,5,1,68,7,143
20140305,44,3,17,1,5,1,61,9,141
20140306,47,2,17,1,6,2,78,6,159
20140307,72,5,34,3,10,1,107,19,251
20140308,72,4,30,4,10,1,78,9,208
20140309,20,2,4,0,3,0,16,8,53
20140310,69,7,33,4,7,1,92,17,230
20140311,66,8,30,7,10,0,110,12,243
20140312,79,6,32,2,7,1,102,28,257
20140313,83,8,34,0,7,1,95,14,242
20140314,80,11,27,3,13,1,123,19,277
20140315,77,5,27,0,12,0,94,15,230
20140316,22,2,4,0,1,0,28,1,58
20140317,77,10,28,5,9,3,104,14,250
20140318,51,8,19,1,5,0,75,14,173
20140319,118,15,34,6,14,1,173,25,386
20140320,74,6,20,4,5,0,99,14,222
20140321,86,11,22,1,4,0,85,10,219
20140322,62,9,25,0,5,2,106,16,225
20140323,42,8,12,2,3,1,53,9,130
20140324,79,6,16,4,7,0,87,10,209
20140325,62,6,17,3,7,1,114,19,229
20140326,67,12,33,1,5,0,99,14,231
20140327,68,11,23,1,6,1,98,17,225
20140328,71,6,20,1,6,2,92,11,209
20140329,83,10,32,3,11,1,104,16,260
20140330,35,1,4,0,3,1,39,2,85
20140331,43,5,24,3,7,0,91,17,190
20140401,77,12,24,4,11,1,132,14,275
20140402,69,7,25,1,6,1,91,13,213
20140403,52,7,22,0,2,2,81,9,175
20140404,47,6,31,2,9,2,77,9,183
20140405,75,10,25,3,10,2,105,9,239
20140406,22,6,6,0,1,0,23,5,63
20140407,63,7,21,2,5,2,93,8,201
20140408,79,11,33,4,10,0,113,19,269
20140409,50,9,23,3,7,0,106,18,216
20140410,54,12,8,1,5,0,50,11,141
20140411,57,11,23,2,5,0,97,16,211
20140412,49,2,21,2,1,0,67,7,149
20140413,17,3,4,0,4,0,24,5,57
20140414,36,4,16,1,4,0,62,8,131
20140415,38,4,14,0,6,0,50,5,117
20140416,36,6,19,2,3,0,59,11,136
20140417,34,5,13,1,3,0,46,9,111
20140418,22,4,13,1,2,0,36,10,88
20140419,61,3,26,4,4,1,59,15,173
20140420,17,2,8,0,1,1,26,3,58
20140421,30,2,14,1,4,1,40,3,95
20140422,79,11,29,3,4,1,91,23,241
20140423,37,3,18,2,3,0,55,6,124
20140424,24,4,16,1,5,0,72,9,131
20140425,48,3,18,3,5,0,76,14,167
20140426,46,7,25,3,7,2,87,11,188
20140427,25,3,9,2,1,1,24,7,72
20140428,83,9,35,5,5,3,117,13,270
20140429,88,15,26,3,14,1,114,12,273
20140430,88,8,29,4,11,1,130,22,293
20140501,58,7,26,3,6,2,87,8,197
20140502,81,6,30,2,10,0,100,12,241
20140503,51,9,20,2,4,1,87,20,194
20140504,22,4,13,2,2,0,32,14,89
20140505,55,3,18,3,6,0,75,6,166
20140506,50,4,21,3,9,0,64,13,164
20140507,76,7,25,4,11,0,107,12,242
20140508,30,5,16,1,3,0,52,8,115
20140509,53,4,22,2,3,3,94,15,196
20140510,41,3,15,5,9,0,76,9,158
20140511,24,3,7,1,1,1,22,5,64
20140512,72,5,24,1,9,0,109,15,235
20140513,37,0,13,1,5,0,54,3,113
20140514,40,2,16,0,6,0,60,15,139
20140515,68,4,26,1,5,3,81,11,199
20140516,57,8,19,4,5,0,96,21,210
20140517,78,12,25,5,10,5,97,15,247
20140518,23,4,12,1,3,0,34,8,85
20140519,66,6,22,3,6,1,107,19,230
20140520,85,11,28,1,4,1,135,18,283
20140521,93,11,32,4,9,1,108,11,269
20140522,99,15,29,3,7,1,150,20,324
20140523,95,7,42,1,12,2,134,12,305
20140524,50,9,26,2,9,1,100,20,217
20140525,27,2,5,1,0,1,28,11,75
20140526,87,14,26,4,5,0,108,16,260
20140527,87,15,22,1,11,0,99,15,250
20140528,48,2,16,2,5,0,66,15,154
20140529,67,6,23,3,5,0,82,15,201
20140530,67,12,17,7,4,0,98,22,227
20140531,85,12,25,2,6,1,121,15,267
20140601,37,2,11,0,2,0,67,4,123
20140602,67,6,19,0,7,0,122,15,236
20140603,85,7,22,4,4,4,103,13,242
20140604,75,7,29,1,2,1,110,15,240
20140605,74,10,18,3,7,0,99,18,229
20140606,66,10,23,3,9,2,110,18,241
20140607,38,8,21,1,3,1,75,7,154
20140608,18,6,7,3,1,1,36,7,79
20140609,82,6,23,5,6,1,88,9,220
20140610,32,11,11,0,3,0,59,9,125
20140611,47,5,17,2,5,0,66,11,153
20140612,26,3,6,0,4,0,40,7,86
20140613,65,2,28,2,5,0,72,18,192
20140614,70,5,25,6,10,1,111,16,244
20140615,25,3,8,1,4,0,40,3,84
20140616,56,3,16,0,2,1,66,8,152
20140617,33,4,10,0,3,1,54,5,110
20140618,39,6,15,0,5,1,47,7,120
20140619,32,0,6,4,1,0,46,5,94
20140620,57,10,18,2,4,0,74,10,175
20140621,46,6,21,4,8,0,75,12,172
20140622,25,3,9,1,2,0,32,5,77
20140623,19,5,10,0,4,0,41,3,82
20140624,53,5,20,1,5,0,86,13,183
20140625,38,3,8,1,2,0,36,7,95
20140626,33,4,22,3,5,1,51,18,137
20140627,58,7,26,2,7,1,92,6,199
20140628,35,4,14,0,4,0,46,3,106
20140629,18,4,5,0,1,0,18,6,52
20140630,54,4,34,1,5,0,81,16,195
20140701,48,7,20,1,9,0,96,17,198
20140702,64,6,21,3,10,0,88,17,209
20140703,84,9,27,5,4,2,81,16,228
20140704,31,3,12,0,5,0,43,9,103
20140705,34,3,7,0,4,0,53,3,104
20140706,14,2,5,1,1,0,19,3,45
20140707,41,9,19,2,9,1,57,7,145
20140708,37,4,14,0,3,1,48,8,115
20140709,54,3,18,2,3,0,67,7,154
20140710,60,5,23,1,10,1,96,17,213
20140711,74,6,20,4,4,0,102,22,232
20140712,46,11,13,2,3,0,63,8,146
20140713,11,1,6,0,0,0,22,3,43
20140714,32,5,18,0,5,0,67,8,135
20140715,50,4,21,3,6,1,77,9,171
20140716,58,7,26,1,8,1,116,16,233
20140717,64,7,19,1,5,3,84,16,199
20140718,59,4,23,2,1,0,75,14,178
20140719,62,2,14,2,8,0,74,12,174
20140720,17,2,6,0,2,0,28,3,58
20140721,42,9,27,1,8,0,78,11,176
20140722,59,12,19,2,4,0,98,12,206
20140723,87,12,28,3,8,0,122,20,280
20140724,50,6,19,1,7,2,81,12,178
20140725,66,11,28,2,7,0,80,12,206
20140726,52,6,19,2,3,0,89,10,181
20140727,15,2,4,1,0,0,25,5,52
20140728,42,5,16,1,8,0,72,10,154
20140729,46,5,23,2,8,1,62,9,156
20140730,58,6,23,2,7,0,77,9,182
20140731,53,10,32,4,6,2,99,8,214
20140801,67,10,27,1,8,1,101,8,223
20140802,44,7,15,1,3,0,56,9,135
20140803,25,1,7,0,3,0,39,7,82
20140804,45,9,15,1,9,0,59,10,148
20140805,85,9,26,3,3,1,98,13,238
20140806,48,2,24,1,5,0,75,17,172
20140807,39,7,23,1,2,1,59,14,146
20140808,81,10,24,4,9,1,88,14,231
20140809,42,4,16,1,2,0,71,6,142
20140810,16,1,7,1,0,0,22,3,50
20140811,68,9,26,4,4,1,113,17,242
20140812,71,3,32,4,5,0,103,15,233
20140813,53,7,17,6,3,0,85,14,185
20140814,38,3,18,1,1,1,55,9,126
20140815,53,9,13,1,6,0,59,11,152
20140816,44,5,9,1,6,0,65,11,141
20140817,14,1,10,0,4,1,46,5,81
20140818,61,5,29,7,8,0,76,22,208
20140819,98,16,25,0,16,2,123,23,303
20140820,54,10,17,6,5,1,71,8,172
20140821,63,12,15,4,10,2,94,13,213
20140822,50,5,26,3,6,2,65,18,175
20140823,68,9,17,2,12,0,95,15,218
20140824,20,3,8,1,4,0,26,5,67
20140825,93,10,32,8,6,0,113,14,276
20140826,77,10,16,2,8,1,113,23,250
20140827,105,10,26,3,12,4,126,9,295
20140828,72,9,21,3,10,1,96,18,230
20140829,92,10,18,6,5,0,109,8,248
20140830,68,6,20,1,9,0,95,15,214
20140831,18,0,4,2,0,0,21,6,51
20140901,85,11,26,4,11,2,111,16,266
20140902,73,8,16,3,10,0,94,10,214
20140903,67,7,10,1,3,2,74,13,177
20140904,58,7,25,2,6,1,93,13,205
20140905,46,10,15,2,6,0,80,8,167
20140906,42,5,16,1,1,1,67,16,149
20140907,26,3,6,0,2,1,29,4,71
20140908,48,6,17,2,4,1,62,9,149
20140909,65,8,29,2,8,0,89,21,222
20140910,77,9,28,3,4,1,96,14,232
20140911,73,9,25,1,11,1,88,11,219
20140912,59,3,31,1,7,1,82,9,193
20140913,62,10,23,2,8,0,92,17,214
20140914,16,5,7,3,2,1,27,4,65
20140915,68,11,24,0,14,3,84,8,212
20140916,76,7,23,2,3,1,101,26,239
20140917,72,6,24,7,8,1,115,21,254
20140918,67,7,22,2,1,0,81,13,193
20140919,82,11,23,1,13,0,110,17,257
20140920,75,5,29,4,13,1,91,11,229
20140921,15,1,3,1,1,0,33,6,60
20140922,45,6,20,0,6,1,59,4,141
20140923,46,4,21,2,5,0,98,11,187
20140924,50,11,29,5,8,0,89,11,203
20140925,55,7,17,3,5,2,93,11,193
20140926,74,7,22,0,3,1,104,10,221
20140927,46,7,15,1,12,0,96,23,200
20140928,13,4,10,0,2,0,25,4,58
20140929,74,7,23,2,5,1,77,19,208
20140930,90,11,38,0,13,0,108,22,282
20141001,68,7,22,0,7,1,91,14,210
20141002,63,4,22,2,6,0,80,6,183
20141003,69,9,29,0,6,1,122,16,252
20141004,87,10,15,3,8,1,94,13,231
20141005,7,3,1,1,2,1,16,3,34
20141006,57,5,19,2,2,1,68,11,165
20141007,64,15,30,1,10,0,102,11,233
20141008,79,12,23,7,10,5,97,23,256
20141009,73,11,25,3,10,12,118,25,277
20141010,56,7,18,2,5,5,82,14,189
20141011,51,13,14,2,3,1,107,15,206
20141012,22,5,11,1,5,2,48,2,96
20141013,45,1,19,2,5,0,72,10,154
20141014,69,4,16,0,7,2,77,12,187
20141015,48,4,13,3,6,0,85,13,172
20141016,58,2,15,6,6,5,70,9,171
20141017,57,6,27,5,16,10,94,19,234
20141018,35,4,13,2,2,6,61,13,136
20141019,33,3,12,2,1,3,28,5,87
20141020,50,11,21,5,6,5,70,10,178
20141021,42,4,22,3,8,5,63,4,151
20141022,50,6,15,4,3,0,71,7,156
20141023,79,14,29,4,7,1,102,16,252
20141024,64,7,30,3,8,1,104,7,224
20141025,83,8,23,2,4,2,81,11,214
20141026,10,0,1,0,1,1,20,8,41
20141027,46,4,27,2,6,0,91,11,187
20141028,48,4,14,0,2,1,81,8,158
20141029,54,5,22,6,6,5,56,8,162
20141030,67,9,30,2,4,0,82,15,209
20141031,79,4,21,5,11,1,98,11,230
20141101,70,11,25,1,7,2,81,14,211
20141102,21,2,9,0,1,1,29,5,68
20141103,49,6,17,0,5,1,67,9,154
20141104,39,5,19,2,4,1,65,14,149
20141105,49,4,13,4,10,0,75,8,163
20141106,50,9,13,2,5,1,53,5,138
20141107,48,7,22,0,3,0,64,7,151
20141108,30,3,16,1,2,0,46,12,110
20141109,25,1,3,1,1,0,21,4,56
20141110,51,9,13,1,5,1,84,10,174
20141111,50,4,19,2,4,0,66,7,152
20141112,56,3,22,0,9,1,82,13,186
20141113,76,11,38,5,7,2,82,18,239
20141114,63,9,20,1,7,0,85,17,202
20141115,27,2,10,0,3,1,28,6,77
20141116,11,3,7,0,0,0,29,1,51
20141117,53,5,20,0,8,1,76,12,175
20141118,55,10,25,2,5,0,99,20,216
20141119,52,4,12,5,7,2,64,10,156
20141120,26,5,4,1,1,0,60,7,104
20141121,59,4,18,1,9,1,90,10,192
20141122,51,6,17,0,4,0,78,10,166
20141123,16,0,1,1,2,0,22,4,46
20141124,64,7,17,6,6,0,61,10,171
20141125,180,28,57,5,17,3,280,53,623
20141126,191,21,54,7,25,2,245,25,570
20141127,59,3,27,1,3,1,83,13,190
20141128,75,11,16,2,5,0,87,20,216
20141129,91,11,24,3,8,1,140,21,299
20141130,25,0,5,1,2,1,32,5,71
20141201,52,3,15,0,4,0,100,11,185
20141202,57,4,20,3,10,1,102,11,208
20141203,56,7,29,3,3,0,94,12,204
20141204,42,5,28,2,4,4,81,14,180
20141205,59,10,22,3,8,2,91,10,205
20141206,49,13,22,1,5,1,77,16,184
20141207,24,5,9,0,0,0,38,4,80
20141208,74,8,28,4,4,0,95,15,228
20141209,47,6,23,3,4,5,67,7,162
20141210,75,6,20,1,7,3,77,9,198
20141211,49,5,22,3,7,6,79,13,184
20141212,49,5,16,3,9,2,84,16,184
20141213,54,7,19,1,5,0,65,13,164
20141214,28,4,13,0,6,0,32,2,85
20141215,52,4,13,4,2,0,65,8,148
20141216,67,3,20,3,5,3,68,8,177
20141217,62,9,21,4,8,1,81,9,195
20141218,36,7,20,0,5,1,72,15,156
20141219,43,5,13,3,4,1,66,14,149
20141220,77,8,24,1,4,1,86,12,213
20141221,22,2,11,1,3,1,22,3,65
20141222,41,7,17,0,1,0,67,11,144
20141223,59,4,18,4,1,0,75,8,169
20141224,31,1,15,0,0,1,55,1,104
20141225,9,3,2,2,0,0,12,1,29
20141226,51,4,13,3,8,1,82,7,169
20141227,47,3,16,1,6,1,57,12,143
20141228,16,0,11,2,3,0,38,3,73
20141229,45,8,20,5,3,0,79,11,171
20141230,64,5,25,2,8,0,74,11,189
20141231,126,17,52,2,8,0,140,16,361
20150101,0,0,0,0,0,0,0,0,0
20150102,62,4,20,3,7,0,107,8,211
20150103,31,7,17,0,2,0,59,8,124
20150104,12,0,6,0,1,0,22,3,44
20150105,52,6,27,2,7,1,79,6,180
20150106,55,8,23,2,9,3,88,8,196
20150107,54,5,18,1,11,3,97,8,197
20150108,54,6,27,3,6,3,65,11,175
20150109,59,5,22,0,13,0,96,10,205
20150110,55,6,15,2,8,1,66,7,160
20150111,20,2,9,2,2,0,24,0,59
20150112,47,4,26,1,11,0,74,10,173
20150113,57,2,16,2,7,1,70,13,168
20150114,53,3,15,4,4,0,62,11,152
20150115,53,7,17,3,3,0,79,9,171
20150116,61,5,21,1,7,0,82,7,184
20150117,65,6,25,1,8,2,54,13,174
20150118,24,3,9,1,1,2,30,8,78
20150119,70,13,28,2,9,0,94,12,228
20150120,51,6,9,2,7,0,37,3,115
20150121,67,9,34,2,5,0,83,17,217
20150122,54,11,24,1,4,0,82,13,189
20150123,70,12,37,5,11,1,127,23,286
20150124,79,16,29,0,6,1,99,16,246
20150125,30,4,7,0,2,0,27,2,72
20150126,63,7,27,2,10,2,107,19,237
20150127,53,5,23,1,3,0,85,10,180
20150128,66,3,16,4,1,1,101,15,207
20150129,64,4,38,3,6,0,87,14,216
20150130,83,10,34,4,13,3,122,14,283
20150131,60,6,18,3,4,1,70,20,182
20150201,17,3,3,0,2,3,32,4,64
20150202,75,7,19,3,12,2,103,24,245
20150203,91,11,35,2,5,0,109,25,278
20150204,93,15,35,5,8,2,156,16,330
20150205,58,6,25,2,10,0,78,9,188
20150206,62,8,24,8,2,1,79,13,197
20150207,91,7,28,3,5,0,114,9,257
20150208,27,3,10,2,5,0,26,8,81
20150209,75,10,21,3,6,0,84,16,215
20150210,71,10,26,4,10,0,91,12,224
20150211,91,7,24,5,11,1,130,20,289
20150212,66,6,26,1,10,3,106,14,232
20150213,81,10,30,4,7,2,115,18,267
20150214,37,9,20,2,2,1,61,18,150
20150215,22,0,8,0,3,4,30,6,73
20150216,57,6,25,2,6,0,87,4,187
20150217,17,3,13,3,4,0,25,2,67
20150218,41,4,16,2,6,0,49,11,129
20150219,44,7,21,0,4,1,69,14,160
20150220,74,5,23,1,7,1,103,18,232
20150221,62,10,16,3,7,0,87,11,196
20150222,35,2,5,0,2,0,50,6,100
20150223,60,7,28,3,9,1,86,10,204
20150224,89,6,25,1,4,0,114,17,256
20150225,71,13,25,3,6,0,109,12,239
20150226,72,9,32,1,7,0,106,17,244
20150227,76,3,27,4,13,1,115,10,249
20150228,74,4,30,3,8,1,99,15,234
20150301,30,1,10,2,6,0,36,5,90
20150302,77,6,21,4,11,0,78,7,204
20150303,59,7,15,2,9,1,74,13,180
20150304,61,5,19,4,7,1,87,8,192
20150305,74,14,25,3,6,0,102,19,243
20150306,63,13,20,3,3,0,94,16,212
20150307,84,12,36,1,11,0,93,22,259
20150308,31,4,14,0,4,0,41,5,99
20150309,74,8,34,3,6,0,84,12,221
20150310,50,4,19,3,6,2,71,18,173
20150311,63,6,18,1,4,0,83,18,193
20150312,67,3,24,2,7,1,96,16,216
20150313,78,5,22,1,12,0,94,12,224
20150314,66,14,27,1,6,1,90,18,223
20150315,24,0,2,1,4,0,33,6,70
20150316,59,13,15,1,8,1,86,22,205
20150317,93,10,18,0,12,0,112,18,263
20150318,60,9,19,5,7,0,87,21,208
20150319,70,9,22,1,5,4,83,16,210
20150320,91,14,33,2,14,0,126,25,305
20150321,48,6,21,4,9,1,104,14,207
20150322,26,4,19,0,4,1,50,12,116
20150323,74,11,14,2,13,2,103,15,234
20150324,68,6,26,3,7,3,90,12,215
20150325,68,9,20,2,14,1,88,8,210
20150326,69,9,31,2,6,0,107,24,248
20150327,57,11,22,3,7,1,79,17,197
20150328,50,10,19,2,7,0,73,15,176
20150329,21,1,6,1,1,0,33,6,69
20150330,72,4,31,2,6,2,102,16,235
20150331,74,3,33,5,13,0,105,19,252
20150401,38,4,20,1,10,1,78,10,162
20150402,37,6,21,4,8,1,72,10,159
20150403,31,4,8,4,4,0,50,5,106
20150404,35,4,10,4,10,2,67,6,138
20150405,21,2,6,1,1,1,27,6,65
20150406,54,9,19,1,2,2,78,17,182
20150407,60,9,28,1,4,0,84,7,193
20150408,57,7,19,4,9,2,97,10,205
20150409,78,6,36,2,18,2,109,12,263
20150410,59,10,27,2,4,1,74,18,195
20150411,49,2,23,1,6,3,71,10,165
20150412,10,1,8,0,1,0,18,7,45
20150413,58,4,21,3,2,1,69,11,169
20150414,36,3,14,0,2,0,71,11,137
20150415,84,8,22,1,6,2,121,18,262
20150416,46,7,27,2,8,0,86,5,181
20150417,46,4,18,1,5,0,66,11,151
20150418,56,6,13,2,5,1,83,15,181
20150419,7,0,2,0,2,0,21,7,39
20150420,62,2,19,5,7,0,76,6,177
20150421,42,5,15,1,6,0,41,15,125
20150422,41,5,18,2,5,1,68,8,148
20150423,32,3,8,1,5,0,45,4,98
20150424,73,8,21,3,4,1,83,14,207
20150425,46,9,17,2,10,2,78,9,173
20150426,33,2,6,0,2,0,34,1,78
20150427,69,8,25,2,4,2,96,12,218
20150428,79,10,24,3,7,1,85,7,216
20150429,56,8,25,3,6,0,109,18,225
20150430,79,9,24,7,12,1,105,19,256
20150501,36,1,10,2,4,1,44,11,109
20150502,41,4,11,2,2,0,60,7,127
20150503,16,1,9,1,0,0,15,2,44
20150504,66,9,18,2,10,0,99,11,215
20150505,76,5,23,1,6,0,71,11,193
20150506,65,7,23,1,5,1,89,7,198
20150507,35,10,15,2,4,1,60,13,140
20150508,43,6,16,1,8,0,69,9,152
20150509,47,5,16,3,6,0,92,8,177
20150510,15,0,6,1,1,1,25,3,52
20150511,51,6,21,3,5,1,83,8,178
20150512,61,10,25,2,4,2,94,9,207
20150513,64,10,21,2,6,1,69,17,190
20150514,58,8,21,2,4,1,86,15,195
20150515,43,5,22,2,5,0,85,8,170
20150516,73,5,17,3,4,1,79,15,197
20150517,12,3,2,0,1,0,25,1,44
20150518,61,11,25,2,8,0,98,12,217
20150519,39,6,9,0,2,0,65,10,131
20150520,43,5,19,2,3,0,74,6,152
20150521,50,7,16,3,1,0,76,13,166
20150522,50,5,24,3,9,1,79,9,180
20150523,42,10,19,1,5,0,73,8,158
20150524,27,2,5,1,2,0,33,6,76
20150525,69,3,24,1,4,2,101,14,218
20150526,55,7,25,3,8,1,76,8,183
20150527,46,5,16,2,6,0,64,10,149
20150528,54,4,22,1,2,0,60,5,148
20150529,41,7,13,1,6,2,75,9,154
20150530,71,8,25,0,7,1,85,9,206
20150531,10,1,4,0,2,0,18,5,40
20150601,41,6,18,2,8,2,67,12,156
20150602,48,2,14,1,3,0,71,7,146
20150603,48,8,18,0,9,0,72,8,163
20150604,40,4,7,2,3,0,41,3,100
20150605,62,3,14,4,12,1,85,12,193
20150606,43,5,11,2,7,1,59,10,138
20150607,16,2,4,3,3,1,30,5,64
20150608,51,9,24,2,5,2,127,25,245
20150609,93,10,35,2,7,2,115,17,281
20150610,73,6,20,0,11,1,117,16,244
20150611,58,7,27,3,5,0,90,18,208
20150612,97,10,37,5,10,0,134,14,307
20150613,64,9,12,3,8,0,71,10,177
20150614,15,3,6,0,3,1,47,11,86
20150615,69,10,34,1,9,1,92,12,228
20150616,58,6,19,0,5,0,108,10,206
20150617,88,6,34,1,8,2,125,15,279
20150618,90,19,34,3,11,1,106,21,285
20150619,105,19,31,2,12,2,116,19,306
20150620,65,16,32,2,13,2,115,14,259
20150621,27,4,7,1,2,1,54,7,103
20150622,70,10,16,1,3,0,84,18,202
20150623,103,14,21,8,7,0,125,21,299
20150624,64,14,28,3,7,0,98,25,239
20150625,59,5,18,2,6,1,69,8,168
20150626,47,8,18,2,7,2,74,12,170
20150627,71,12,29,3,7,1,103,15,241
20150628,31,3,7,1,7,0,41,4,94
20150629,48,10,19,0,7,1,74,12,171
20150630,61,10,27,5,8,1,127,19,258
20150701,42,4,21,0,5,1,68,15,156
20150702,42,8,16,0,3,1,76,10,156
20150703,85,8,24,3,6,1,105,11,243
20150704,72,10,21,0,6,0,97,12,218
20150705,25,4,2,1,1,0,49,10,92
20150706,55,8,19,1,8,0,70,10,171
20150707,43,4,13,3,8,1,68,11,151
20150708,56,3,23,1,9,0,70,10,172
20150709,48,4,14,6,5,1,84,13,175
20150710,78,9,17,3,5,0,87,15,214
20150711,61,5,14,5,1,1,71,12,170
20150712,25,1,3,2,2,0,27,3,63
20150713,62,9,20,1,6,1,100,12,211
20150714,99,9,28,5,4,1,121,13,280
20150715,79,6,30,5,7,0,110,21,258
20150716,43,3,17,2,5,1,56,20,147
20150717,48,3,18,1,1,0,90,15,176
20150718,56,11,18,2,5,1,67,18,178
20150719,17,2,7,1,1,0,27,4,59
20150720,61,6,25,3,4,0,91,15,205
20150721,48,6,19,3,9,0,73,18,176
20150722,28,4,18,2,7,1,75,7,142
20150723,43,5,20,1,5,0,79,11,164
20150724,61,9,21,3,5,0,95,10,204
20150725,80,7,23,3,7,1,117,16,254
20150726,14,3,6,1,1,0,14,3,42
20150727,73,2,21,2,5,0,107,11,221
20150728,55,5,22,2,6,0,74,17,181
20150729,72,4,22,6,3,1,115,11,234
20150730,75,9,28,4,13,1,126,19,275
20150731,79,7,29,3,4,1,90,19,232
20150801,61,5,16,0,6,1,86,16,191
20150802,34,3,4,2,3,0,42,7,95
20150803,75,4,23,1,4,2,109,21,239
20150804,37,4,15,1,7,0,62,5,131
20150805,73,5,16,0,6,2,96,13,211
20150806,48,8,15,1,4,0,73,7,156
20150807,58,4,18,2,9,1,73,3,168
20150808,56,5,22,4,4,0,74,11,176
20150809,13,1,9,0,1,0,23,1,48
20150810,62,7,17,2,8,0,71,11,178
20150811,106,20,42,4,9,1,131,18,331
20150812,70,14,24,4,5,2,101,13,233
20150813,51,8,19,3,8,1,87,20,197
20150814,79,8,31,4,10,0,89,6,227
20150815,49,7,17,2,7,2,81,12,177
20150816,28,4,13,2,4,1,40,3,95
20150817,75,9,32,2,11,2,93,8,232
20150818,71,6,25,3,5,3,85,9,207
20150819,89,14,19,4,6,1,114,16,263
20150820,82,12,21,4,5,2,131,20,277
20150821,90,3,27,3,13,2,115,16,269
20150822,72,8,28,5,6,0,94,11,224
20150823,27,2,10,0,5,0,47,8,99
20150824,94,10,28,2,8,1,102,10,255
20150825,84,5,27,0,4,0,115,14,249
20150826,86,12,24,2,8,2,112,13,259
20150827,82,8,25,2,11,1,99,13,241
20150828,72,8,26,3,12,1,108,14,244
20150829,63,6,17,2,4,0,81,22,195
20150830,27,5,7,2,4,0,33,4,82
20150831,83,7,27,4,12,1,86,12,232
20150901,57,11,15,4,9,0,73,15,184
20150902,47,4,18,0,1,0,59,8,137
20150903,46,5,23,6,7,0,63,16,166
20150904,54,6,9,2,5,0,81,7,164
20150905,60,4,25,1,5,1,79,8,183
20150906,8,0,8,1,2,1,21,3,44
20150907,31,8,8,0,3,0,32,3,85
20150908,55,5,28,2,7,0,91,17,205
20150909,52,6,29,4,4,2,85,11,193
20150910,76,5,30,3,8,0,86,16,224
20150911,48,3,23,1,8,0,71,9,163
20150912,51,5,17,1,9,0,64,8,155
20150913,32,2,8,0,2,0,32,4,80
20150914,52,2,9,2,9,1,81,16,172
20150915,70,8,14,1,6,0,82,21,202
20150916,62,4,23,2,12,2,90,10,205
20150917,58,9,17,3,2,2,72,20,183
20150918,70,17,16,0,6,3,95,14,221
20150919,26,0,14,5,7,0,54,1,107
20150920,23,4,7,0,2,0,36,1,73
20150921,49,4,18,0,9,1,73,13,167
20150922,53,6,20,1,5,2,72,9,168
20150923,63,3,25,5,10,0,84,9,199
20150924,51,7,12,0,7,0,64,7,148
20150925,52,2,16,0,7,1,60,7,145
20150926,57,1,31,3,10,2,98,19,221
20150927,25,3,6,2,5,0,26,2,69
20150928,62,7,18,1,7,1,120,21,237
20150929,52,6,23,2,5,0,76,7,171
20150930,62,9,28,1,7,0,93,8,208
20151001,56,8,29,2,8,1,94,11,209
20151002,44,7,23,0,2,1,65,14,156
20151003,58,8,26,1,9,0,101,12,215
20151004,17,1,3,0,3,0,26,10,60
20151005,70,10,24,2,6,1,98,12,223
20151006,92,11,28,3,7,1,102,13,257
20151007,69,11,29,1,8,1,107,15,241
20151008,82,10,33,2,8,1,98,12,246
20151009,87,9,37,2,11,0,131,11,288
20151010,78,5,29,5,11,1,106,22,257
20151011,19,0,3,0,0,0,15,5,42
20151012,36,1,6,0,2,1,42,6,94
20151013,50,5,18,3,8,0,69,8,161
20151014,52,3,16,2,2,1,90,19,185
20151015,61,6,23,3,4,0,71,17,185
20151016,64,8,22,3,5,0,73,6,181
20151017,69,7,14,2,6,1,91,8,198
20151018,17,6,4,1,1,0,26,4,59
20151019,86,13,23,1,7,1,106,11,248
20151020,51,5,15,1,4,1,93,9,179
20151021,78,7,25,2,8,0,104,14,238
20151022,48,7,11,6,7,2,77,6,164
20151023,44,9,15,4,6,0,83,11,172
20151024,58,5,21,1,6,0,88,14,193
20151025,17,2,11,1,8,0,33,8,80
20151026,79,5,31,3,6,0,107,13,244
20151027,35,9,21,1,5,0,67,9,147
20151028,39,6,18,3,6,0,69,14,155
20151029,67,9,23,2,3,1,110,19,234
20151030,60,6,20,3,5,2,82,15,193
20151031,49,9,17,5,4,0,82,10,176
20151101,20,1,5,2,3,0,27,5,63
20151102,27,1,9,0,3,0,49,9,98
20151103,41,3,11,3,3,2,53,12,128
20151104,48,7,23,7,13,2,68,16,184
20151105,60,7,21,1,7,1,78,11,186
20151106,54,6,18,3,8,1,126,16,232
20151107,58,9,17,4,9,0,88,12,197
20151108,23,6,9,1,1,0,40,5,85
20151109,46,9,22,3,4,0,79,11,174
20151110,77,4,29,2,5,0,101,13,231
20151111,65,11,22,2,11,3,71,12,197
20151112,59,7,23,2,8,2,112,8,221
20151113,78,9,24,5,10,0,108,13,247
20151114,33,4,8,0,6,1,65,7,124
20151115,20,1,5,2,3,0,22,3,56
20151116,38,6,18,2,7,2,80,10,163
20151117,37,3,14,1,6,1,55,14,131
20151118,73,9,21,1,8,0,108,13,233
20151119,49,5,22,4,5,0,68,5,158
20151120,31,8,8,2,6,0,47,16,118
20151121,72,4,17,3,8,0,94,8,206
20151122,28,1,13,0,2,1,32,3,80
20151123,39,7,19,4,4,1,82,10,166
20151124,64,2,18,2,6,0,97,11,200
20151125,199,26,62,6,23,1,305,40,662
20151126,174,24,52,2,20,3,245,40,560
20151127,196,25,68,7,24,1,281,38,640
20151128,94,13,37,6,5,2,120,14,291
20151129,36,3,12,3,1,0,57,9,121
20151130,73,10,30,7,13,2,125,10,270
20151201,57,9,19,1,7,1,75,17,186
20151202,43,2,15,2,4,0,90,10,166
20151203,71,6,31,2,14,1,104,19,248
20151204,50,6,19,4,7,1,76,13,176
20151205,93,14,37,3,10,2,106,26,291
20151206,25,1,3,0,3,0,35,7,74
20151207,42,4,14,1,8,1,67,8,145
20151208,53,9,14,1,4,0,78,11,170
20151209,26,3,8,0,0,0,33,3,73
